  [Header]
//Format=TTS dictionary
//Title=Evgeny Stepanov Nikoly TTS 5.1 Cube
//Author=Evgeny Stepanov
//Version=1
//Date=02.12.2009
//Description=(Russian)Cловарь для движка Николай TTS 5.1 Cube||Евгения Степанова.||Версия 1.||- 4830 слов и словосочетаний:||- произношения английских слов;||- имена, фамилии;||- слова и фразы с омографами;||-сокращения.

[Data]
fwd.=forward
Кроме самого Императора= Кроме самовооо Императора
&=энд
-60ос=-60 градусов по Цельсию
-70ос=-70 градусов по Цельсию
10-й=десятый
100%=100 процентов
100-кубовой=100-кубоъвой
1000-километровой=тысяче-километровой
105-миллиметровая=сто-пяти-миллиметроовая
105-миллиметровая пушка=сто-пяти-миллиметроовая пуъшка
105-миллиметровой=сто пяти-миллиметрооовой
105-миллимитровых =сто-пяти-миллимитрооовых 
105-мм орудие=сто-пяти-миллиметроовое орудие
110-метровую=сто десяти метровую
12-го=двенадцатого
120-миллиметровую=сто двадцати-миллиметрооовую
120-миллиметровые=сто-двадцати-миллиметроовые
13 января=тринадцатое января
13-го=тринадцатого
14-го=четырнадцатого
15 января=пятнадцатого января
15-метровый=пятнадцати-метровый
16-го=шестнадцатого
16-ричную=шестнадцатирииииичную
1750 год=тысяча семьсот пятидесятый год
17853-й=семнадцать тысяч восемьсот пятьдесят третий
17896 года=семнадцать тысяч восемьсот девяносто шестого года
1984 в двоичном исчислении=тысяча 984 в двоичном исчислении
1993 года=тысяча девятьсот девяносто третьего года
1с=1 эс
2 в степени=два в степени
20 декабря 2022 года=двадцатого декабря две тысячи двадцать второго года
20-летней=двадцатилетней
2000-летними=двухтысяче-летними
2001 года=две тысячи первого года
209-й=двести девятый
24-часовой=двадцати четырёх--часовой
24-часовую=двадцати четырёх-часовую
27 октября=двадцать седьмого октября
28 минут=28 минуут
28 октября=двадцать восьмого октября
28-го=двадцать восьмого
29 марта 2022 года=двадцать девятого марта две тысячи двадцать второго года
3 билета 3769=третьего билета три тысячи семьсот шестьдесят девятого
3 мая=третьего мая
30-летней=тридцатилетний
31-го=тридцать первого
3a тeм=За тем
3с =3 эс 
418-й=четыресто восемнадцатый
42-го=сорок второго
43%=43 процента
4713 года=четыре тысячи семьсот тринадцатого  года
4x4=4 на 4
4А=4 Аа
4с=4 эс
512 в квадрате=пятьсот двенадцать в квадрате
5а=5 аа
5с =5 эс 
64 МБ ТРЕБУЕТСЯ=шестьдесят четыре мегабайта требуется
6а=6 аа
7%=7 процентов
70-мм пушек=семидесяти-миллеметрооовых  пушек
700 083 доллара=семьсот тысяч 083 доллара
75%=75 процентов
8-й=восьмой
98-го=девяносто восьмого
AMR=а-эм-эр
Apple=Эпл
asdf=эй-эс-ди-эф
Bable-Sorter=бэйбл-сота
BMW=бэ-эм-вэ
Bye-I=бай-один
Christmas=христмас
Computers=компьютес
deja vu=дежавюуу
Dimension=дименшен
Dr=доктор
etc=и-ти-си
F8=эф 8
FM-радиоприёмников=эф-эм-радиоприёмников
Future=фьюче
GPS=Джи-пи-эс
GSC=джи-эс-си
GUCCI=Гучи
h=аш
II век=второй век
II века=второго века
II веке=втором веке
II-го=второго
II-й=второй
III век=третий век
III века=третьего века
III веке=третьем веке
III-го =третьего
III-й=третий
IV век=четвёртый век
IV века=четвёртого века
IV веке=четвёртом веке
IV-го=четвёртого
IV-й=четвёртый
IX век=девятый век
IX века=девятого века
IX веке=девятом веке
IX-го=девятого
IX-й=девятый
iсq=ай-си-кью
John =Джон
Kodak=коъдак
L=эль
LIVE=лайв
Microsoft=майкросооофт
MP3book2005=эм-пэ-три-бук-две тысячи пять
n-ного=энного
n-ского=энского
n-ском=энском
Nationale=нэйшенл
Neskafe=нескафэээ
Nestle=несттлеэ
Noise=нойс
Nokia=ноокия
NSA=эн-эс-эй
oт=от
PDA=пэ-дэ-аа
Pioner-10=Pioner 10
Playstation=плэй стэйшн
PR-компании=пи-ар-компании
Rad-X=Rad-икс
Russia=раша
Russian=рашин
RVCool=ар-ви-кул
S=эс
Seagate=сигээйт
SMS=эС-эМ-эС
SS=эс-эс
Sun=сан
T=ти
table=тэйбл
the=вэ
time=тайм
Trash-80=Trash 80
True=тру
TV-тюнера=ти-ви-тюунера
txt=ти-икс-ти
United =Юнайтед
V=ви
v-образные=вэобразные
v-образным=вэобраазным
VI век=шестой век
VI века=шестого века
VI веке=шестом веке
VI-го=шестого
VI-й=шестой
VII век=седьмой век
VII века=седьмого века
VII веке=седьмом веке
VII-го=седьмого
VII-й=седьмой
VIII век=восьмой век
VIII века=восьмого века
VIII веке=восьмом веке
VIII-го=восьмого
VIII-й=восьмой
VISA=Виза
VlP-персон=Вип-персон
W=дубль вэ
We=уии
X век=десятый век
X века=десятого века
X веке=десятом веке
X-го=десятого
X-й=десятый
XI век=одиннадцатый век
XI века=одиннадцатого века
XI веке=одиннадцатом веке
XI-го=одиннадцатого
XI-й=одиннадцатый
XII век=двенадцатый век
XII века=двенадцатого века
XII веке=двенадцатом веке
XII-го=двенадцатого
XII-й=двенадцатый
XIII век=тринадцатый век
XIII века=тринадцатого века
XIII веке=тринадцатом веке
XIII-го=тринадцатого
XIII-й=тринадцатый
XIV век=четырнадцатый век
XIV века=четырнадцатого века
XIV веке=четырнадцатом веке
XIV-го=четырнадцатого
XIV-й=четырнадцатый
XIX век=девятнадцатый век
XIX века=девятнадцатого века
XIX веке=девятнадцатом веке
XIX-го=девятнадцатого
XIX-й=девятнадцатый
XV век=пятнадцатый век
XV века=пятнадцатого века
XV веке=пятнадцатом веке
XV-гo=пятнадцатого
XV-го=пятнадцатого
XV-й=пятнадцатый
XVI век=шестнадцатый век
XVI века=шестнадцатого века
XVI веке=шестнадцатом веке
XVI-го=шестнадцатого
XVI-й=шестнадцатый
XVII век=семнадцатый век
XVII века=семнадцатого века
XVII веке= сенадцатом веке
XVII-го=семнадцатого
XVII-й=семнадцатый
XVIII век=восемнадцатый век
XVIII века=восемнадцатого века
XVIII веке=восемнадцатом веке
XVIII-го=восемнадцатого
XVIII-й=восемнадцатый
XX век=двадцатый век
XX века=двадцатого века
xx веке=двадцатом веке
XX веке=двадцатом веке
XX-го=двадцатого
XX-й=двадцатый
y-хромосома=игрэк-хромосома
Z=зэт
А в чем=А в чём
А вот ноги=А вот ноъги
а вот тренажер=а вот тренажёр
А вы помните слова=А вы поомните словаа
а глаза - слепыми=а глазаа - слепыми
а дальше - бегом=а дальше - бегоом
а дальше все элементарно=а дальше всё элементарно
а дело-то все=а дело-то всё
А до этою прогуливались=А до этого прогуливались
а заплатите чем =а заплаатите чем 
а кругом - схватка=а кругоом - схватка
А кругом вместо кипящего океана=А кругоом вместо кипящего океана
а не ноги=а не ноъги
а ноги=а ноъги
а ноги - тоже=а ноъги - тоже
а она наверняка узнает=а она наверняка узнаъет
а по-моему речь=а по-мооему речь
а после руки=а после руъки
А при чем здесь=А при чём здесь
а самого так=а самовооо так
а стены=а стеъны
а так все нормально=а так всё нормально
а толку=а тоълку
А уж в чем=А уж в чём
а узнают - поглядим=а узнаъют - поглядим
А-4=А 4
А-а-ах-х-х=А-а-аххх
Аldebaran=Альдебараааан
Аабарака-Тафелалета=Аабарааака-Тафелалеээта
аадаванца=аадавааанца
Аадаваны=Аадаваааны
Аальстаха=Аальстааха
Аальстахе=Аальстаахе
аарианскими=аариаанскими
аарианскую=аариаанскую
Аарон=Аарооон
аба'ка=абаака
аба'кам=абаакам
аба'ками=абааками
аба'ках=абааках
аба'ке=абааке
аба'ки=абааки
аба'кой=абаакой
аба'кою=абаакою
аба'ку=абааку
Абагейл=Абагеээйл
абазинской=абазиинской
абазинцев=абазиинцев
абака=абакааа
абака'м=абакааам
абака'ми=абакааами
абака'х=абакааах
абакан=абакааан
абакана=абакаана
абаканов=абакаанов
абаке=абакеээ
абаки=абакиии
абако'й=абакооой
абако'ю=абакоою
абаку=абакууу
абакумов=абакуумов
Абатай=Абатааай
Абатай-хан=Абатааай-хан
Абатай-хана=Абатааай-хана
Абатай-хану=Абатааай-хану
аббасидский=аббасииидский
аббат-бенедиктинец=аббат-бенедиктииинец
аббатиса=аббатииса
аббатисе=аббатиисе
аббатисой=аббатиисой
аббатису=аббатиису
аббатисы=аббатиисы
аббревиатурная=аббревиатуурная
абверовец=ааабверовец
Абд-аль-Рашид=Абд-аль-Рашиид
Абд-альРашид=Абд-альРашииид
Абд-альРашидом=Абд-альРашиидом
Абд-Рахим =Абд-Рахиим 
Абдалла=Абдаллааа
Абдаллах=Абдаллааах
Абдаллах-Бахари=Абдаллааах-Бахариии
Абдельсалам=Абдельсалаааам
Абдельсаламу=Абдельсалаааму
абдул=абдуул
Абдул-эль-Марийака=абдуул-эль-Марийаака
Абдула=Абдулааа
Абдулаев=Абдулааев
абдулла=абдуллааа
Абдулле=Абдуллеээ
Абдуллой=Абдуллооой
абдуллу=абдуллууу
абдуллы=абдуллыыы
Абдулой=Абдулооой
Абдулу=Абдулууу
Абдулы=Абдулыы
Абдурахман=Абдурахмаааан
Абдурахмана=Абдурахмааана
абежать=абежааать
Абеля=Аабеля
Абердин=Абердииин
Абердином=Абердиином
аберкрейв-инн=аберкреээйв-инн
аберкромби=аберкроомби
аберрантом=аберраантом
Аберфордом=Аберфоордом
Аберфорта=Аберфоорта
Аберфортом=Аберфоортом
Аберфорту=Аберфоорту
Аберфрау=Аберфраау
Абигайль=Абигааайль
Абиджан=Абиджааан
абиджане=абиджаане
абингдон=аабингдон
абиссинец=абиссиинец
абиссински=абиссиински
абиссинца=абиссиинца
абиссинцах=абиссиинцах
абиссинцев=абиссиинцев
абиссинцы=абиссиинцы
абитура =абитуура 
абитуриентским=абитуриеээнтским
абляционном=абляциооонном
абляционные=абляциооонные
абнера=аабнера
аболиционистов=аболиционииистов
аболиционистом=аболиционииистом
абонементского=абонемеэнтского
абонентский=абонеэнтский
абонентских=абонеэнтских
абонентской=абонеэнтской
абордажник=абордаажник
аборигенками=аборигеээнками
аборигенке=аборигеээнке
аборигенки=аборигеээнки
аборигенку=аборигеээнку
аборигенная=аборигеэнная
аборигенного=аборигеэнного
аборигенное=аборигеэнное
аборигенной=аборигеээнной
аборигенному=аборигеэнному
аборигенные=аборигеээнные
аборигенный=аборигеээнный
аборигенным=аборигеээнным
аборигенных=аборигеээнных
аборигеночек=аборигеээночек
аборигенские=аборигеээнские
аборигенских=аборигеээнских
аборигеншу=аборигеээншу
Абортивный=Абортиивный
абортированные=абортиированные
Абрагамс=Аабрагамс
Абрамович=Абрамоович
Абрамовича=Абрамоовича
Абрамса=Аабрамса
Абрамсе=Аабрамсе
Абрамсов=Аабрамсов
Абрамсом=Аабрамсом
Абрау-Дюрсо=Абрау-Дюрсоо
абрахам =аабрахам 
Абрахама=Ааабрахама
Абрахаму=Ааабрахаму
Абраханских=Абрахаанских
абрахаса=абрахааса
абсент=абсээнт
абсолютам=абсолюутам
абсолютистских=абсолютииистских
абсолютно правы=абсолютно правыы
абсолютно свежее=абсолютно свеэжее
абсолютнос=абсолюутнос
абсолютность=абсолюутность
абсолютов=абсолюутов
абсолютум=абсолюутум
абсолютус=абсолюутус
абсолюты=абсолюуты
абсонитизированы=абсонитизиированы
абсонитно-сверхличностных=абсониитно-сверхличностных
абсонитном=абсониитном
абсонитны=абсониитны
абсонитным=абсониитным
абсонитных=абсониитных
абсорбциометр=абсорбциооометр
абстинентный=абстинеэнтный
абстинентов =абстинеэнтов 
абстракционистка=абстракциониииистка
абстракционистки=абстракциониииистки
абсурднейшее=абсуурднейшее
абсурднейшие=абсуурднейшие
абсцинент=абсцинеээнт
абу-омар-ахмед=абуу-омар-ахмээд
Абу-Салим=Абуу-Салиим
Абу-Симбел=Абуу-Симбеэл
Абу-Симбела=Абуу-Симбеэла
Абуласан=Абуласаааан
Абуласанову=Абуласаанову
Абулгази=Абулгазииии
абулия=абулиия
Абульгази=Абульгазиии
Абулькасима=Абулькасииима
Абульфарач=Абульфараааач
Абульфеда=Абульфеэда
Абуторонга=Абуторооонга
абухао=абухаао
абылай=абылааай
Абыр=Абыыр
Аваллон=Аваллооон
Аваллона=Аваллоона
Аваллоне=Аваллооне
Аваллону=Аваллоону
аваллонцы=аваллоонцы
Авалон=Авалооон
Авалона=Авалоона
Авалоне=Авалооне
авалонец=авалоонец
Авалоном=Авалооном
авалонский=авалоонский
авалонским=авалоонским
авалонских=авалоонских
авалонской=авалоонской
авалонцев=авалоонцев
авалонцы=авалоонцы
Аваль=Авааль
авальонна=авальоонна
авангардистка=авангардииистка
авангардно=авангаардно
авангардно-кубических=авангаардно-кубических
авангардно-штурмовых=авангаардно-штурмовых
аванпостам=аванпостаааам
аванпостами=аванпостааами
аванпостом=аванпостоооом
авантажах=авантаажах
авантюрином=авантюрииином
авантюристична=авантюристиииична
авантюристичной=авантюристиииичной
авантюристка=авантюрииистка
авантюристке=авантюрииистке
авантюристки=авантюрииистки
авантюристкой=авантюрииисткой
авантюристку=авантюрииистку
авантюристов-бостонцев=авантюристов-боостонцев
авантюристок=авантюрииисток
авантюрность=авантюурность
авантюрьера=авантюрьеээра
авантюрьеров=авантюрьеээров
Авард=Аваард
аварийка=авариийка
аварийку=авариийку
аватар=аватааар
аватара=аватаара
аватарам=аватаарам
аватарах=аватаарах
аватаре=аватааре
аватаров=аватааров
аватарой=аватаарой
аватаром=аватааром
аватару =аватаару 
аватары=аватаары
авачинская=аваачинская
авачинского=аваачинского
АВБ-1=АВБ 1
Аввакум =Аввакууум 
Аввакума=Аввакуума
Аввакумом=Аввакуумом
Авгиевы=Ааавгиевы
авгиевых=ааавгиевых
августейше=августеэйше
Августин=Аавгустин
августин=Аавгустин
августина=августиина
Августине=Августиине
Августином =Августиином 
Августину=Августиину
августинцев=августииинцев
Августы-Фредерики-Вильгельмины=Авгуъсты-Фредерики-Вильгельмиины
Авдеевича=Авдеэевича
Авдеевичем=Авдеэевичем
Авдеевичу=Авдеэевичу
Авдей=Авдеэй
Авдула=Авдулааа
Авелем=Аавелем
авелом=авелооом
Авелю=Аавелю
Авеля=Аавеля
авенид=авенииид
авенида=авениида
авениде=авенииде
авениды=авенииды
Авербаха=Авербааха
Авербахом =Авербаахом 
аверс=аъверс
аверса =ааверса 
аверсе=ааверсе
Аверха=Ааверха
Аверхом=Ааверхом
Аверху=Ааверху
Аверьян=Аверьяаан
Аверьяна=Аверьяана
Аверьяном=Аверьяаном
Аверьяну=Аверьяану
Авессалом=Авессалоооом
Авессалома=Авессалооома
Авессаломе=Авессалоооме
Авессаломом=Авессалооомом
Авессалому=Авессалооому
авиа=аавиа
авиабилет=аавиа-билет
авиабилета=аавиа-билета
авиабилетами=аавиа-билетами
авиабилетах=аавиа-билетах
авиабилетов=аавиа-билетов
авиабилеты=аавиа-билеты
авиабомбежки=аавиа-бомбежки
авиагоризонта=аавиа-горизонта
авиагруппе=аавиа-группе
авиагруппировка=аавиа-группировка
авиагруппу=аавиа-группу
авиагруппы=аавиа-группы
авиадесантироваться=аавиа-десантироваться
авиадорогу=аавиа-дорогу
авиазаводчику =аавиа-заводчику 
авиазвено=аавиа-звено
авиаиндустрия=аавиа-индустрия
авиаинженеров=аавиа-инженеров
авиаконверт=аавиа-конверт
авиакорпус=аавиа-корпус
авиакорпуса=аавиа-корпуса
авиакрыла=аавиа-крылаа
авиакрыло=аавиа-крылоо
авиакрылом=аавиа-крылом
авиакрылу=аавиа-крылу
авиакрыльев=аавиа-крыльев
авиакрылья=аавиа-крылья
авиакрыльям=аавиа-крыльям
авиакрыльях=аавиа-крыльях
авиалодка=аавиа-лодка
авиалодке=аавиа-лодке
авиалоцман=аавиа-лоцман
авиалюбитель=аавиа-любитель
авиамаршрутах =аавиа-маршрутах 
авиамаршруты=аавиа-маршруты
авиамашина=аавиа-машина
автолет=автолёт
автолетной=автолётной
автоматизированно=автоматизиированно
автоматчиц=автомаатчиц
автосигнализации=автосигнализаааации
адовая=ааадовая
адовым=аадовым
адреналина=адреналииина
адъютантка=адъютаантка
адъютантке=адъютаантке
адъютанток=адъютаанток
азиатофобия=азиатофоообия
айкидо=айкидооо
Акварина=Аквариина
Акварину=Аквариину
Акварины=Аквариины
аккуратными рожками=аккуратными роожками
акогда=а когда
аксонах=аксоънах
Альдебарана=Альдебарааана
Амазони=Амазоони
Амбал=Амбаал
Амундсена=Ааамундсэна
амфитаминов=амфитамииинов
анабиозе=анабиооозе
Ангел-1=Ангел 1
Ангел-2=Ангел 2
Ангел-2 на связи=Ангел два на связи
ангельски=аангельски
Англичане на скачки=Англичане на скаъчки
АНДАНОР=анданооор
Анданор=анданооор
Анданор =анданооор 
анданор-ской=анданооорской
анданор-цы=анданооорцы
Анданора =Анданоора 
Анданоре=Анданооре
Анданорец=Анданоорец
анданорец=Анданоорец
Анданорианка=Анданориааанка
анданорианка=Анданориааанка
анданорианке=анданориааанке
анданорианки=анданориааанки
анданорианкой=анданориааанкой
анданорианок=анданориааанок
анданорианских=анданориааанских
Анданором=Анданоором
анданорский=анданоорский
анданорский Интернет=анданоорский Интэрнэээт
анданорским=анданоорским
анданорских=анданоорских
анданорской=анданоорской
анданорском=анданоорском
Анданору=Анданоору
анданорца=анданоорца
анданорцам=анданоорцам
анданорцев=анданоорцев
анданорцем=анданоорцем
Анданорцы=Анданоорцы
анданорцы=Анданоорцы
Андерсена =Ааандэрсэна 
андерсеновская=ааааандэрсэновская
Андерсеном=Ааандэрсэном
Андерсон=Аандэрсон
Андерсонов =Ааандэрсонов 
Анджея=Аанджея
Аненекуилько=Аненекуииилько
АНОРЭ=Анорэ
антигравитации=антигравитааации
антигравитационное=антигравитациооооонное
антиисторичности=антиисторииичности
антиисторичность=антиисториииичность
антимоскитными=антимоскиитными
антипартийность=антипартииийность
антипригарного=антипригаарного
Антор=Антоор
антресоль=антресоооль
Аполлидору=Аполлидооору
аполловские=апоолловские
апперкотом=апперкоотом
аппетитные запахи =аппетитные заапахи 
Апфелу=Аапфелу
арбалетов=арбалеэтов
Арбата=Арбаъта
аргонавтов=аргонаавтов
аргонавты=аргонаавты
Арзан=Арзаан
аристократичны=аристократиииичны
Артан=Артаан
архаист=архаииист
архаистов=архаиистов
Архаисты=Архаиисты
архаисты=Архаиисты
Атлантиды=Атлантииды
атоммаши=атоммааши
атриум=аатриум
атриума=ааатриума
аудивизуальный=аудивизуааальный
Аэротранс=Аэротраааанс
бадмаевскому=бадмааевскому
Байроном=Баайроном
бальзаковскому=бальзааковскому
барахлить=барахлииить
барахлят=барахляаат
барбитуратов=барбитурааатов
Баумгольц=Баумгооольц
Баумгольца=Баумгоольца
Бауэри=Бааауэри
башки всякому=башкии всякому
башку отстриг=башкуу отстриг
Беверли-Хилс=Бээвэрли-Хилс
Без ведома автора=Без веэдома автора
без вести пропавшая=без вести пропаавшая
без вести пропавшей=без вести пропаъвшей
без мужа матери=без мужа маатери
без рельсов или проводов=без рельсов или проводооов
без следа и осложнений=без следаа и осложнений
без устали сменявших=без уустали сменявших
безболезнен=безболеэзнен
бездонные дыры пустоты=бездонные дыры пустотыыы
безнадегой=безнадёгой
Белгород =Беэлгород 
Белгорода=Беээлгорода
Белгородом=Беээлгородом
белокрылый=белокрыылый
Беломор=Беломооор
Белоснежки=Белоснеэжки
белых зубок=белых зуъбок
беседовавшие друг с другом пары=беседовавшие друг с другом паъры
бестолковыми коробками =бестолковыми корообками 
бешено прыгающее в груди=бешено прыгающее в грудии
бившееся в груди=бившееся в грудии
биокибернетик=биокибернээээтик
биокибернетических=биокибернетиииических
биомагнитофонную=биомагнитофоооонную
биополей=биополеэээй
биосистемой=биосистеээмой
бисептол=бисептооол
благо кругом островов=благо кругоом островов
благородно-белесые=благородно-белеъсые
благородно-белесые пряди=благородно-белеъсые пряъди
бластера=блаастера
бледно-зеленых=блеъдно-зеленых
бледно-салатовым=блеъдно-салатовым
блекло-розовую=блеъкло-розовую
блефануть=блефануууть
блохозавр=блохозааавр
блохообразным=блохообрааазным
богами Анданора =богами Анданоора 
богоподобный=богоподоообный
боись=боиись
более полно ощущал меня=более поълно ощущал меня
болота и озера=болота и озёра
большая часть энергии =боольшая часть энергии 
Бом-м-ммм=Бомммм
Бонапарта=Бонапаарта
бонусы=боонусы
бороды сейчас в моде=боороды сейчас в моде
Босса забылась=Босса забыълась
ботиночками =ботииночками 
Бр-р-р=Быррр
Бреверу=Бреэверу
бред все это=бред всё это
брелка=брелкаа
бренди или виски=брэнди или виъски
Бриннером=Брииннером
Бритэйн=Бритээйн
броневичок=броневичоооок
бронетехов=бронетеэхов
бронике=броонике
бруклинских=брууклинских
брызнули слезами=брызнули слёзами
бугаина=бугаиина
будь другом=будь друъгом
буковка=бууковка
буковки=бууковки
Буратино=Буратиино
буря приземлит =буъря приземлит 
бусины слез =бусины слёз 
Буффало=Буффаъло
Бухенвальд=Бухенвааальд
был другом=был друъгом
был слишком далеко=был слишком далекооо
была заменена=была замененаааа
была слишком далеко =была слишком далекооо 
были внутри стены =были внутри стеныы 
были запрещены оккупантами=были запрещеныыыы оккупантами
были посыпаться из его головы=были посыпаться из его головыыы
были уже дома=были уже доъма
было далеко=было далекооо
было равно 200=было равно двухстаам
было темно-синим=было тёмно-синим
БЭРРОУЗ=Бэрроуз
Бэтмена=Бээтмэна
бюстгальтер=бюстггальтэр
в 1933 году=в тысяча девятьсот тридцать третьем году
в 1967 году=в тысяча девятьсот шестьдесят седьмом году
в 1975 году=в тысяча девятьсот семьдесят пятом году
в 23 часа=в 23 часаа
в 90-с годы=в девяностые годы
в Антиохии первого века=в Антиохии первого веъка
В банке города=В банке гоорода
в болезненной полудреме дома=в болезненной полудреме доъма
в буквальном смысле слова=в буквальном смысле слоъва
в виде головы=в виде головыыы
в виде двоичного числа =в виде двоичного числаа 
в военном тире=в военном тиъре
в Володиной груди=в Володиной грудии
в вооружённых силах Земли=в вооружённых силах Землии
в восемь утра=в восемь утраа
в выборных органах=в выборных оорганах
в глаза рассмеялся=в глаза рассмеяался
в глобальном смысле этого слова=в глобальном смысле этого слоъва
в глубине голоса =в глубине гоолоса 
В глубине души=В глубине душии
в глубине души=В глубине душии
в голосе среднего лица=в голосе среднего лицаа
в голубовато-золотистых тонах=в голубовато-золотистых тонаах
в груди начала подниматься=в грудии началааа подниматься
в девять утра=в девять утраа
в десять утра=в десять утраа
в душе восхищаясь ею=в душеэ восхищаясь ею
в душе он был далеко=в душеэ он был далекооо
в его дела и судьбы=в его делаа и суЪдьбы
в его мозгу=в его мозгуу
в ее собственной душе=в ее собственной душеэ
в жаркое пространство=в жааркое пространство
в живописном рванье =в живописном рваньеэ 
в запекшейся крови=в запёкшейся крови
в известные правила игры=в известные правила игрыы
в каких-то коробках=в каких-то короъбках
в качестве официального лица=в качестве официального лицаа
в кожаном переплете розового цвета=в кожаном переплете розового цвеъта
в колледжах недоучиваются=в кооолледжах недоуучиваются
в колледжах Старого=в кооолледжах Старого
в конце первого века=в конце первого веэка
В коралловой толще острова=В коралловой толще оострова
в лавровом венке =в лавроовом венкеэ 
В любви нет места третьему=В любви нет меъста третьему
в магазинных витринах Города=в магазинных витринах Гоорода
в направлении головы=в направлении головыыы
В нашей комнате=В наъшей комнате
в нашей комнате=В наъшей комнате
в нашей маленькой=в наъшей маленькой
в нашей проблеме=в наъшей проблеме
в наших колледжах=в наших коолледжах
в нечто большее=в неччто боольшее
в неясные очертания берега=в неясные очертания беэрега
в обществе пары таких тварей=в обществе паъры таких тварей
в один комплекс=в один коъмплекс
в одиннадцать вечера=в одиннадцать веэчера
в одиночку вырезало целые семьи=в одиночку вырезаало целые семьи
в окне своего дома=в окне своего доъма
в парной бане=в парноой бане
в поисках целей=в поисках цеълей
в полете=в полёте
в полете потеряла=в полёте потеряла
в поте лица=в поте лицаа
в почти не защищенном=в почти не защищённом
в пределах самого острова=в пределах самовооо острова
в пробивании энергетического поля=в пробивании энергетического поъля
в проеме окна=в проеме окнаа
в пятиста метрах=в пятистах метрах
в разгромленное помещение=в разгрооомленное помещение
в разные стороны=в разные стоороны
в районе левой стороны=в районе левой стороныыы
в районе реки=в районе рекии
В результате шестьдесят два места=В результате шестьдесят два меъста
в родном селе=в родном селеэ
в самое пекло=в саамое пекло
в самом ближайшем =в саъмом ближайшем 
в самом главном=в саъмом главном
в самом деле=в саъмом деле
В самом же крайнем=В саъмом же крайнем
в самом зените=в саъмом зените
в самом конце=в саъмом конце
в самом ли деле=в саъмом ли деле
В самом начале=В саъмом начале
в самом начале=В саъмом начале
в самом низу=в саъмом низуу
в самом первом=в саъмом первом
в самом последнем=в саъмом последнем
в самом разгаре=в саъмом разгаре
в самом сердце внутренних тюрем=в саъмом сердце внутренних тюрем
в самом страшном=в саъмом страшном
в самом узком месте=в саъмом узком месте
в самом центре=в саъмом центре
в самом широком=в саъмом широком
в сверкающую золотом=в сверкающую зоолотом
в свете луны=в свете луныы
в связи с безжалостной=в связии с безжалостной
в связи с важностью=в связии с важностью
В связи с вышесказанным=В связии с вышесказанным
В связи с ними =В связии с ними 
в связи с особенной=в связии с особенной
В сенате шестьдесят два места=В сенате шестьдесят два меъста
в случае войны=в случае войныы
в состоянии войны=в состоянии войныы
в Страстную пятницу=в Страстнуую пятницу
в струящихся почти до земли=в струящихся почти до землии
в табачного цвета=в табачного цвеъта
в таких коробках=в таких короообках
в театральном кружке=в театральном кружкеэ
в театральном кружке Дома пионеров=в театральном кружкеэ Доъма пионеров
в телефонных проводах=в телефонных проводааах
в толще земли=в толще землии
В толще острова=В толще оострова
в фонтане осколков оконного стекла=в фонтане осколков оконного стеклаа
в характере магнитного поля=в характере магнитного поъля
В центре Города=В центре Гоорода
в центре поля=в центре поъля
В чем=В чём
в чем дело=В чём дело
в чем сейчас обвиняет=В чём сейчас обвиняает
В чем-то вы=В чём-то вы
в черной монашеской рясе замер=в черной монашеской рясе заъмер
в четыре голоса=в четыре гоолоса
В шесть часов вечера=В шесть часов веэчера
в штатское агентов обоего пола=в штатское агентов обоего поъла
в эпицентре этой игры=в эпицентре этой игрыы
Валиум=Ваалиум
Валиума=Вааалиума
Вам знаком некий=Вам знакоом некий
вам уже все рассказали=вам уже всё рассказали
вампиризма=вампириизма
вареностями=варёностями
варшавяне=варшавяане
вас он сразу узнает=вас он сразу узнаъет
Василь=Васииль
Ватсона=Ваатсона
ваш Невидимка к проблеме пола=ваш Невидимка к проблеме поъла
вбрасывать=вбраасывать
вбуравливалось=вбураавливалось
вбухивается=вбуууухивается
вверх и в стороны=вверх и в стоороны
ввинтим=ввинтиим
Вдвоем мы вас=Вдвоём мы вас
вдоль борта=вдоль бортаа
вдохнула её запах=вдохнула её заъпах
ведомые ей рычажки=веээдомые ей рычажки
ведь это слова=ведь это словаа
величественной САМОЙ ЗЕМЛЕЙ=величественной САМоОЙ ЗЕМЛЕЙ
верил в это особенно остро=верил в это особенно оъстро
Веркина=Веэркина
Веркином =Веэркином 
вернёётся=вернётся
Веррье=Веррьеэ
Веррье и сыновья=Веррьеэ и сыновьяаа
Веррье-отель=Веррьеэ-отель
вертикальной оси=вертикальной осии
верхнапряжения=верх напряжения
верхом удобнее и легче=верхоом удобнее и легче
весельная=вёсельная
весенним дождем=весенним дождём
Весла выбросить=Вёсла выбросить
весной 2022 года=весной две тысячи двадцать второго года
вестерна=вээстэрна
вестернах=вээстэрнах
ветер в груди=ветер в грудии
вещей стене=веъщей стене
вжавшуюся=вжааавшуюся
вжикнули=вжиикнули
взаимодополнявших=взаимодополняаааавших
взаимоприязни=взаимоприяазни
взаиморасположение=взаиморасположеээээние
взаиморасположение органов внутренних=взаиморасположеээээние оорганов внутренних
взаиморасположению=взаиморасположеээээнию
вздела горе шприц=вздела гоъре шприц
взобраться на берег=взобраться на беърег
взревновала=взревноваала
взрослому вести себя=взрослому вестии себя
взятие сказочного замка=взятие сказочного заъмка
взять меня в жены=взять меня в жёны
взять под прицел окна=взять под прицел оъкна
видел все это=видел всё это
видел ее ребра=видел ее рёбра
видел их лица=видел их лиъца
видеоплеер =видеоплэээер 
видеоскопы=видеоскооопы
видеотеки=видеотеээки
видеоучебника=видеоучеээбника
видеоэффектов=видео-эффектов
Видера=Виидера
виду - в районе сорока =виду - в районе сорокааа 
вижу - стоит Мечта=вижу - стоиит Мечта
визжащих далеко за полночь=визжащих далекооо за полночь
виллочкой=вииллочкой
Вильсоном=Виильсоном
виртуали=виртуаали
виртуаль=виртуааль
виртуалью =виртуаалью 
виски я не взял=виъски я не взял
Висту=Виъсту
висящими на груди=висящими на грудии
вишенками=вииишенками
Вия=Виъя
вкрадчивым заглядыванием=вкрадчивым загляаадыванием
влажнее=влажнеэе
властными родами=властными родаъми
влитые в хрустальную прозрачность=влитыъе в хрустальную прозрачность
вмурованного=вмурооованного
вмурованное=вмуроованное
вмурованностью=вмурооованностью
вмурованные в изменяемые стены =вмурооованные в изменяемые стены 
вмуровать=вмуровааать
вневременная=вневременнааая
во все большее замешательство=во все боольшее замешательство
во все стороны=во все стоороны
Во всей округе=Во всей окруъге
во всем ищет выгоды=во всЁм ищет выгоды
во всем любит порядок=во всём любит порядок
во всем мире=во всём мире
во всем мне хочется=во всём мне хочется
во всем остальном=во всём остальном
во всем подыгрывать=во всём подыгрывать
во всем своем убожестве=во всём своем убожестве
во всем теле=во всём теле
во всех концах страны=во всех концах страныы
во дворе дома=во дворе доъма
во дворе стоит твое дерево=во дворе стоиит твое дерево
во мраке цвета=во мраке цвеъта
во разные стороны=в разные стоороны
водите нас за нос =вооодите нас за нос 
водометов=водомётов
водорослинки=воооодорослинки
военнопленная=военноплеэнная
военнопленной=военноплеээнной
возбуждений=возбуждеэний
возведя глаза=возведя глазаа
воздухи=вооздухи
воззрившаяся=воззриившаяся
возился с коробками=возился с короъбками
возле самого обогревателя=возле самовооо обогревателя
возле самого окна=возле самовооо окна
вознаграждено=вознагражденооооо
вознаграждены=вознагражденыыыыы
возникнув в двери=возникнув в дверии
вокруг своей оси=вокруг своей осии
Волнообразность=Волнообрааазность
волну мелкой дрожи=волну мелкой дроъжи
волны легко перекатываются=воълны легко перекатываются
волны раскаленного=воълны раскаленного
Володиного=Волоодиного
Володиному=Волооъдиному
Володины глаза =Володины глазаа
Володиными=Волоодиными
Володь=Волоодь
Володя с Леном=Володя с Леной
волоча ноги=волоча ноъги
вольно стоящим=воъльно стояащим
Воннегута=Воннегуута
вооружённые до зубов=вооружённые до зубоов
вооруженных до зубов=вооруженных до зубоов
воплощение самой Империи=воплощение самоой Империи
вопросила=вопросиила
воронковидные=воронковиидные
восемь лет человечество раздирали войны=восемь лет человечество раздирали воъйны
восточносибирской=восточно-сибирской
Восхищенья=Восхищеэнья
восьмистраничный=восьмистраниииичный
Вот такую сучку=Вот такую суъчку
впадинкам=впаадинкам
вперившись=впеэрившись
впилась в кожу=впилаась в кожу
впились зубами=впились зубаъми
врач самой скорой помощи=врач самоой скорой помощи
вредины=вреэдины
Времени уже три часа=Времени уже три часаа
временных рамок=временныыых рамок
вряд ли это сильно изменить=вряд ли это сильно изменит
всё ещё стоящего=всё ещё стояащего
все - изданное когда-то=всё - изданное когда-то
все - не настоящее=всё - не настоящее
Все ближе к тебе=Всё ближе к тебе
все богатство мысли=всё богатство мысли
все более агрессивно=всё более агрессивно
все более диким =всё более диким 
все более заметной=всё более заметной
все более напоминает ему=всё более напоминает ему
все более неживой=всё более неживой
все более обыденной =всё более обыденной 
все более похожей=всё более похожей
все больше казалось=всё больше казалось
все больше молодых женщин=всё больше молодых женщин
все больше убеждаюсь=всё больше убеждаюсь
все будет в порядке=всё будет в порядке
все будет выдаваться=всё будет выдаваться
все будет нормально=всё будет нормально
все будет хорошо=всё будет хорошо
все бы хорошо=всё бы хорошо
Все было в порядке=Всё было в порядке
все было в порядке=Всё было в порядке
все было взаправду=всё было взаправду
все было готово=всё было готово
все было даже еще прекраснее=всё было даже еще прекраснее
Все было зря=Всё было зря
все было наглухо зашторено=всё было наглухо зашторено
все было так=всё было так
все было так просто=всё было так просто
все было чужим=всё было чужим
все быть хорошо=всё быть хорошо
все в душе поэты=все в душеэ поэты
Все в порядке=Всё в порядке
все в порядке =Всё в порядке 
Все в точности соответствовало=Всё в точности соответствовало
Все верно=Всё верно
все видел=всё видел
Все видели убийство=Всеъ видели убийство
все видящий=всё видящий
все вокруг как будто становилось=всё вокруг как будто становилось
все вокруг озарилось=всё вокруг озарилось
все враз прекратилось=всё враз прекратилось
все вроде как стало=всё вроде как стало
все входим в том же=всеъ входим в том же
Все вы знаете причину=Всеъ вы знаете причину
Все вы одинаковы=Всеъ вы одинаковы
Все высказанное Рословым=Всё высказанное Роословым
все вытянулись перед сурово=всеъ вытянулись перед сурово
все выяснит=всё выяснит
все выяснить=всё выяснить
все действительно было в порядке=всё действительно было в порядке
все для него игрушки=всё для него игрушки
Все думал=Всё думал
все еще болевшего =всё еще болевшего 
все еще болела=всё еще болела
все еще были открыты=всё еще были открыты
все еще было непонимающим=всё еще было непонимаающим
все еще висевшей=всё еще висевшей
все еще витает=всё еще витает
все еще возбуждена=всё еще возбуждена
все еще глядел=всё еще глядел
все еще голого=всё еще голого
все еще дымятся песчаные=всё еще дымятся песчаные
все еще жив=всё еще жив
все еще жива=всё еще жива
все еще живого =всё еще живого 
все еще критически относящийся=всё еще критически относящийся
Все еще надеясь=Всё еще надеясь
все еще не была=всё еще не была
все еще не видел=всё еще не видел
все еще не желая=всё еще не желая
все еще не мог=всё еще не мог
все еще не находя=всё еще не находя
все еще не улавливал=всё еще не улавливал
все еще непонимающе =всё еще непонимающе 
все еще обойдется=всё еще обойдется
все еще пахал=всё еще пахал
все еще переполняла=всё еще переполняла
все еще прижимавшего=всё еще прижимавшего
все еще продолжается=всё еще продолжается
все еще пустую=всё еще пустую
все еще работала=всё еще работала
все еще разыскивает=всё еще разыскивает
все еще рядом=всё еще рядом
все еще светились=всё еще светились
все еще сидевшего=всё еще сидевшего
все еще сидел=всё еще сидел
все еще стоит на обочине=всё еще стоиит на обочине
все еще стоит у причала=всё еще стоиит у причала
все еще стоявшим=всё еще стоявшим
все еще стояла=всё еще стояла
все еще только начинается=всё еще только начинается
все еще только присматривался=всё еще только присматривался
все еще улыбающемуся=всё еще улыбающемуся
все еще хранившегося=всё еще хранившегося
все еще чувствовал=всё еще чувствовал
все еще шел=всё еще шел
все ж не сходилось=всё ж не сходилось
Все ждали волшебного слова=Все ждали волшебного слоъва
все же для ученого =всё же для ученого 
все же за столами виднелись=всё же за столами виднелись
все же мне удалось=всё же мне удалось
все же началась бы=всё же началась бы
все же не променяет=всё же не променяет
все же недостаточно соответствовало=всё же недостаточно соответствовало
все же ослепительного=всё же ослепительного
все же перехлынула=всё же перехлынула
все же подчинен=всё же подчинен
все же покончить=всё же покончить
все же попахивала=всё же попахивала
все же придется=всё же придется
все же слегка покраснел=всё же слегка покраснел
все же спрашиваю=всё же спрашиваю
все же убить=всё же убить
все же хотелось=всё же хотелось
ВСЕ ЖЕ ЭТОГО=ВСЁ ЖЕ ЭТОГО
все живое=всё живое
все живые души=все живые дуъши
все жители Земли=все жители Землии
все зависело=всё зависело
все зависит=всё зависит
все заключенные женского пола=всеъ заключенные женского пола
все закончила=всё закончила
все закончилось=всё закончилось
все заметил=всё заметил
все замечающий=всё замечающий
все здесь роскошнее=всё здесь роскошнее
все здесь сейчас так закрутится=всё здесь сейчас так закрутится
все здесь снова напоминало=всё здесь снова напоминало
все здорово там было=всё здоорово там было
все знаешь=всё знаешь
все знал о=всё знал о
все знала=всё знала
все знаю о лжи=всё знаю о лжи
все и началось=всё и началось
Все и так ясно=Всё и так ясно
все идет=всё идет
все имеет=всё имеет
все имели возможность=всеъ имели возможность
Все испортишь=Всё испортишь
Все как в жизни=Всё как в жизни
все когда-либо прочитанное=всё когда-либо прочитанное
все кончено=всё кончено
все кончилось=всё кончилось
все кончится =всё кончится 
все кругом за столиками=все кругоом за столиками
все кругом молчали=все кругоом молчали
все кругом так поступают=все кругоом так поступают
все купе заблюют=всё купе заблююуут
все летит к чертям=всё летит к чертям
Все ли вам понятно=Всё ли вам понятно
все меньше нравился=всё меньше нравился
все меньше степеней свободы=всё меньше степенеээй свободы
Все металлическое=Всё металлическое
все можно успеть=всё можно успеть
все мы так не ценили=всеъ мы так не ценили
все надо делать =всё надо делать 
все началось=всё началось
все начинается сначала=всё начинается сначала
все начиналось сначала=всё начиналось сначала
все не заводил мотора=всё не заводил мотора
все не по-хорошему холодеет=всё не по-хорошему холодеет
все не прекращалась=всё не прекращалась
все необходимое=всё необходимое
все новых случаев=всё новых случаев
все о нем написанное=всё о нем написанное
все о реакции организма=всё о реакции организма
все обернется=всё обернется
все обозначается=всё обозначается
все обойдется=всё обойдется
все обошлось=всё обошлось
все объяснил=всё объяснил
все объяснить=всё объяснить
все объясню=всё объясню
все одна малина=всё одна малина
Все одно=Всё одно
Все одно - три франка=Всё одно - три франка
Все одно бежать тебе некуда=Всё одно бежать тебе некуда
Все они=Всеъ они
все они видели=всеъ они видели
Все они движутся=Всеъ они движутся
все они изолированы =всеъ они изолированы 
все они отличались=всеъ они отличались
все они совершили=всеъ они совершили
Все они стояли=Всеъ они стояли
все они существуют=всеъ они существуют
все они такие белые=всеъ они такие белые
все они ушли=всеъ они ушли
Все опять было так восхитительно=Всё опять было так восхитительно
все остальное =всё остальное 
Все останется=Всё останется
все очень просто=всё очень просто
Все очень просто=всё очень просто
все перепились=все перепилиииись
все повторялось=всё повторялось
все подмечал=всё подмечал
все поймешь сам=всё поймешь сам
все пока еще оставалось=всё пока еще оставалось
Все получалось=Всё получалось
все получалось=Всё получалось
все получилось=всё получилось
все получится=всё получится
все понимает=всё понимает
все понравилось=всё понравилось
все понял=всё понял
все поняла=всё поняла
все порядочное население города=всё порядочное население города
все построим сами=всё построим сами
Все правильно=Всё правильно
все предусмотрела=всё предусмотрела
все прекрасно=всё прекрасно
все приносят друг другу=всеъ приносят друг другу
Все про все в городке=Все про всё в городке
все продумано=всё продумано
все произошло=всё произошло
все происходящее=всё происходящее
Все промышленное=Всё промышленное
все проспал=всё проспал
все просто у тебя=всё просто у тебя
все просто-таки протестует=всё просто-таки протестует
все прошло=всё прошло
все равно - пришел вместе=всё равно - пришел вместе
все равно будет=всё равно будет
все равно бы отбросили=всё равно бы отбросили
все равно был готов=всё равно был готов
все равно было=всё равно было
все равно в закрытом гробу=всё равно в закрытом гробу
все равно Володе=всё равно Володе
все равно до него дойдут=всё равно до него дойдут
все равно догадается=всё равно догадается
все равно ему было=всё равно ему было
все равно казалось=всё равно казалось
все равно лучшая=всё равно лучшая
все равно можно=всё равно можно
все равно не был готов=всё равно не был готов
все равно не в силах=всё равно не в силах
все равно не надо=всё равно не надо
все равно не пришло=всё равно не пришло
все равно не удастся=всё равно не удастся
все равно не хватило=всё равно не хватило
все равно некому=всё равно некому
Все равно ни одного снимка=Всё равно ни одного снимка
все равно обманешь=всё равно обманешь
все равно оставалась=всё равно оставалась
все равно поручил=всё равно поручил
все равно смотрелись=всё равно смотрелись
все равно согласилась=всё равно согласилась
все равно уже была=всё равно уже была
все равно уже едут=всё равно уже едут
все разжевывать=всё разжевывать
все рассказал=всё рассказал
все рассказываешь=всё рассказываешь
все рассказывать=всё рассказывать
все решил =всё решил 
все светло=всё светло
все свое будущее=всё свое будущее
все сделает=всё сделает
все сделала=всё сделала
все сделали вывод=всеъ сделали вывод
все случилось=всё случилось
все слышали этот разговор=всеъ слышали этот разговор
все смазали=всё смазали
Все создается=Всё создается
все сознающий=всё сознающий
все спрашивал=всё спрашивал
все стабильное=всё стабильное
все стало еще запутанней=всё стало еще запутанней
все станет ясно=всё станет ясно
все стихло=всё стихло
все стихнет=всё стихнет
все суммирование информации=всё суммииирование информации
все схвачено=всё схвачено
все так же закованную=всё так же закованную
все так же кушала=всё так же кушала
все так же обнажена=всё так же обнажена
все так же расходился=всё так же расходился
все там было=всё там было
все те же салатово-голубые=всё те же салатово-голубые
все тем же равнодушно-бессмысленным=всё тем же равнодушно-бессмысленным
все тогда было страшно=всё тогда было страшно
все того же больного=всё того же больноъго
все только еще начиналось=всё только еще начиналось
все тяжеловесное=всё тяжеловесное
все у всех=всё у всех
все у нас лучше закрутится=всё у нас лучше закрутится
все увеличивая ставки=всё увеличивая ставки
все уже будет кончено=всё уже будет кончено
все уже знаете ответ=всеъ уже знаете ответ
все уже кончено=всё уже кончено
все уже кончилось=всё уже кончилось
все уже после скорректировал=всё уже после скорректировал
все уляжется =всё уляжется 
все уничтожить=всё уничтожить
все устроило=всё устроило
все хорошо было=всё хорошо было
все четверо перешли на бег=всеъ четверо перешли на бег
все четыре стороны=все четыре стоороны
все что-то кричат=всеъ что-то кричат
все эти полупризнания=все эти полупризнаания
все это - вранье=всё это - враньё
все это буйство растительной жизни=всё это буйство растительной жизни
все это было=всё это было
все это было зафиксировано=всё это было зафиксировано
все это было правдой=всё это было правдой
Все это в силу=Всё это в силу
все это в сумку=всё это в сумку
Все это возможно=Всё это возможно
все это вранье=всё это враньё
Все это готовится=Всё это готовится
Все это действительно=Всё это действительно
все это действительно так здорово=Всё это действительно так здоорово
все это делается=всё это делается
все это должно быть=всё это должно быть
все это забудь=всё это забудь
все это закончилось=всё это закончилось
все это звучало=всё это звучало
все это исчезло=всё это исчезло
Все это можно=Всё это можно
все это назвать=всё это назвать
все это не удручало=всё это не удручало
все это нужно=всё это нужно
все это осталось позади=всё это осталось позади
все это отдашь=всё это отдашь
все это пахнет=всё это пахнет
все это перемалывает=всё это перемалывает
все это покрывалось=всё это покрывалось
все это получит=всё это получит
все это понадобилось=всё это понадобилось
Все это похоже=Всё это похоже
все это привиделось мне=всё это привиделось мне
все это проверим=всё это проверим
все это происходит случайно=всё это происходит случайно
все это редкие исключения=всё это редкие исключения
Все это складывалось=Всё это складывалось
все это слишком серьезно=всё это слишком серьезно
Все это соединялось=Всё это соединялось
все это создавало неприятное=всё это создавало неприятное
все это создавать=всё это создавать
все это сохранилось=всё это сохранилось
все это удалось=всё это удалось
все это узнал=всё это узнал
все это явно не могло=всё это явно не могло
все ярче и разительнее=всё ярче и разительнее
Все ясно=Всё ясно
все ясно=Всё ясно
все-таки=всё-таки
Все-таки поборов себя=всё-таки поборооов себя
всеблаг=всеблааг
всегда ходят парами=всегда ходят паарами
Всем все понятно=Всем всё понятно
Всемилостивом=Всемиилостивом
Всенепременно =Всенепремеээнно 
всех членов семьи =всех членов семьии 
всецеховое=все цеховое
вспомнила её слова=вспомнила её словаа
Вспомнила слова=Вспомнила словаа
ВСРО=вэ-сэ-рэ-оо
вставил ноги=вставил ноъги
всунула ноги=всунула ноъги
всю семью=всю семьюу
втекла=втеклаа
втекла в него самого=втеклаа в него самовооо
Вудвилль=Вудвиилль
Вы все предусмотрели=Вы всё предусмотрели
вы все тот же=вы всё тот же
вы действуете - не пойму=вы действуете - не поймуу
вы любите=вы люубите
вы ля-ля разводите=вы ля-ля развооодите
вы находитесь =вы нахооодитесь 
вы носите ее =вы ноосите ее 
вы поедете верхом=вы поедете верхоом
вы получите конверт=вы полуучите конверт
вы получите по приезде=вы полуучите по приезде
Вы помните по описаниям=Вы поомните по описаниям
Вы помните повязки=Вы поомните повязки
Вы сюда стоите=Вы сюда стоиите
вы так поступите=вы так постуупите
вы ходите в какую-нибудь церковь=вы хоодите в какую-нибуудь церковь
выбелены=выыыбелены
выброски=выыброски
вываляется=выыыываляется
вываляны =выыываляны 
вывернутыми веками=вывернутыми веэками
вывозить из Европы=вывозииить из Европы
выговорешника=выговореэшника
выгрызая=выгрызаая
выгрызем=выыгрызем
выдергивании=выдёргивании
выжженными=выыыжженными
выигравшего на скачках =выигравшего на скаъчках 
выключили из сети=выключили из сетии
выковырить=выыыковырить
выкорчеванного=выыыыыкорчеванного
выкорчевывания=выкорчёвывания
выкрашенный все той же=выкрашенный всё той же
вылазившая=вылаазившая
вылуплений=вылуплеэний
вымазанную пересядьковским потом=вымазанную пересядьковским поътом
вымазаны в грязи =вымазаны в грязии 
вымою руки=вымою руъки
вымученно=выыымученно
вынул весла=вынул вёсла
выпендриться=выыыпендриться
выпрашивающие еду=выпрашивающие едуу
выпростав руки=выпростав руъки
выпуклость груди=выпуклость грудии
Выпуск 11111000000 года=Выпуск одиннадцати милиаардов сто одиннадцати миллионого года
выпучены глаза=выпучены глазаа
выпучив глаза=выпучив глазаа
выпучив при этом глаза=выпучив при этом глазаа
выпучил глаза=выпучил глазаа
выпучил глаза =выпучил глазаа 
выпучила глаза=выпучила глазаа
вырезан=выырезан
вырезанным ломтем=выыыырезанным лоъмтем
выроста=выыроста
высверливали=высвеэрливали
высвободив руки=высвободив руъки
высвободить ноги=высвободить ноъги
высвободить руки =высвободить руъки 
выскользнуло из у меня=выскользнуло у меня
выслеживании=выслеээживании
высоко в горах=высокооо в горах
Высоко в сочной синеве неба=Высокооо в сочной синеве неба
высоко над головами=высокооо над головами
высоко над головой=высокооо над головой
высоко над лесом=высокооо над лесом
высоко он нес=высокооо он нес
высоколобая=высоколообая
высоколобый=высоколоообый
высокоученым=высокоучёным
высот самого Императора=высот самовооо Императора
вытер глаза =вытер глазаа 
вытер ей слезы=вытер ей слёзы
вытерла глаза=вытерла глазаа
вытирала руки=вытирала руъки
вытирать сопли=вытирать соъпли
вытянув ноги=вытянув ноъги
вытянувшего на лету=вытянувшего на летуу
вытянул вперед руки=вытянул вперед руъки
вытянул ноги=вытянул ноъги
вытянула руки=вытянула руъки
выцепил=выыцепил
вычерпывай=вычеърпывай
вычерпывал=вычеърпывал
вычитанные=выыыычитанные
выяснить все до конца=выяснить всё до конца
вээлкаэсэм=вэлкасэээм
Габриэло=Габриээло
гаденького=гаааденького
гаденькой=гааденькой
гаечек=гааечек
гаечкой=гааечкой
газетенка=газетёнка
галактисты=галактиисты
галеоны=галеооны
галилейской=галилеэйской
Галуа=Галуаа
Гамильтон=Гамильтооон
Гамильтона=Гамильтоона
Гамильтоне=Гамильтооне
Гамильтону=Гамильтоону
Гамлета=Гаамлета
гараже у него стоит морозильник =гараже у него стоиит морозильник 
Гарварда=Гаарварда
гарпуном=гарпунооом
гасиенду=гасиеэнду
гасиенды=гасиеэнды
Гастон=Гастоон
гвоздит=гвоздиит
Где его руки=Где его руъки
где полно еды=где полноо еды
где тоже кто-то стоит=где тоже кто-то стоиит
где-нибудь=где-нибуудь
гейзер=геэйзер
геймером=гээймером
ГЕКЛЬБЕРРИ=Гекльберри
Генделя=Гээнделя
генератора запаха=генератора заапаха
герои повести=герои пооовести
гига памяти=гигаа памяти
гигагерца=гигагеэрца
гимнастерочках=гимнастёрочках
гиперкомпьютер=гиперкомпьюуутэр
гиперонных=гипероонных
гипногаллюцинация=гипногаллюцинаааация
Гипнодопрос=Гипнодопроооос
гипнодопрос=Гипнодопроооос
гипнодопросом=гипнодопрооосом
гипномираж=гипномирааааж
гипномиражи=гипномиражииии
Гипномодель=Гипномодээээль
гипнопередачи =гипнопередаааачи 
гипносна=гипноснааа
гипносон=гипносооон
гипнотичность=гипнотиичность
гипноэффект=гипноэффеэээкт
Гитлера=Гиитлера
Глава 2 ПРЕМИЯ ДЛЯ АКАДЕМИКОВ=Глава два ПРЕМИЯ ДЛЯ АКАДЕМИКОВ
Глава 21 ПОБЕГ=Глава двадцать один ПОБЕГ
Глава 3 ПОДВИГ=Глава 3 ПОъДВИГ
Глава 31 УРОК АНДАНОРСКОГО=Глава тридцать один Урок Анданорского
гладенький=глааденький
глаза - зеркало души=глазаа - зеркало души
глаза в глаза=глазаа в глаза
Глаза Владимира=Глазаа Владимира
глаза девушки=глазаа девушки
глаза демона=глазаа демона
глаза его недобро сузились=глазаа его недобро сузились
глаза запали=глазаа запаъли
глаза злые=глазаа злые
глаза и восторженно-испуганное=глазаа и восторженно-испуганное
глаза испуганно глянули=глазаа испуганно глянули
Глаза Леи=Глазаа Леи
глаза мужика=глазаа мужика
глаза открыла=глазаа открыла
Глаза у трехмерного изображения=Глазаа у трехмерного изображения
глаза уже просто необходимо поднять=глазаа уже просто необходимо поднять
глаза широко раскрылись=глазаа широко раскрылись
глаза этих созданий =глазаа этих созданий 
глаза-маслины=глазаа-маслины
глазками-лазерами=глаазками-лазерами
глотала слезы=глотала слёзы
глубоко впечатанным=глубокооо впечатанным
глубоко и свободно вздохнуть =глубокооо и свободно вздохнуть 
глубоко-глубоко=глубокооо-глубокооо
глубокой и свежей=глубокой и свеъжей
гнданорианка=анданориаанка
Говорилки =Говориилки 
Головы нам морочить=Гооловы нам морочить
голодных волков зимой=голодных волкоов зимой
голос нашей командирши =голос наъшей командиирши 
голубейших=голубеэйших
голубочки=голубоочки
гомонящих=гомоняащих
гонимой западным ветром пыли =гонимой западным ветром пыъли 
горе-защитника=гоъре-защитника
горе-фанатиков=гоъре-фанатиков
горел до утра=горел до утраа
Горели свечи=Горели свеъчи
города его страны=городааа его страны
Города-государства=Городааа-государства
горы и джунгли=гоъры и джунгли
горы и острова=гоъры и островааа
горюшко=гоорюшко
горят все свечи=горят все свеъчи
горячей воды=горяъчей воды
горячей пищи=горячей пиъщи
горячей стали=горяъчей стали
горячим тошнотным потом=горяъчим тошнотным поътом
гости-то=гоъсти-то
государственные кредиты=государственные кредиъты
Готовсь=Готоовсь
гравимобилями=гравимобиилями
гранатом„т=гранатомёт
гранатом„та =гранатомёта 
Графа "Город мечты"=Графаа Город мечты
гребков=гребкоов
Гринвичскому=Грииинвичскому
Грозовеет=Грозовеэет
громадье=громадьё
громче тикали=громче тиикали
грузовичка=грузовичкаааа
грузовичке=грузовичкеэээ
губы девушки=гуъбы девушки
губы же=гуъбы же
Губы Леи=Гуъбы Леи
губы своих четырех ртов=гуъбы своих четырех ртов
Гудвина=Гуудвина
Гулливером=Гулливеэром
гуляющие парами =гуляющие паарами 
гусенички=гууусенички
Гэвина=Гээвина
Гэвине =Гээвине 
Д-да=Дда
ДА/НЕТ=ДА НЕТ
Дайте ему виски=Дайте ему виъски
Далеко без грамоты=Далекооо без грамоты
далеко за полночь=далекооо за полночь
далеко заполночь=далекооо зааполночь
Далеко ли путь держите=Далекооо ли путь деэржите
далеко не безгрешны =далекооо не безгрешны 
далеко не все=далекооо не все
далеко не глупы=далекооо не глупы
далеко не конец=далекооо не конец
далеко не так полезно=далекооо не так полезно
далеко не уверен=далекооо не уверен
далеко от дома=далекооо от дома
Далеко по северо-востоку бродил=Далекооо по сеэверо-востоку бродил
Далеко путь держите=Далекооо путь деэржите
далеко-далеко=далекооо-далекооо
дало по воде кривую дорожку=даъло по воде кривую дорожку
данный индивид женского пола находится=данный индивид женского поъла находится
Дарвина=Даарвина
даром едите=даром едиъте
два часа=два часаа
двадцатишестилетняя=двадцати-шести-летняя
две пальмы на фоне горы=две пальмы на фоне горыы
двенадцатичасовые=двенадцатичасовыыыыые
Двух третей=Двух треътей
двухмиллиардного=двухмиллиаардного
двухсотграммовая=двухсотграммоовая
двухсотграммовую=двухсотграммоовую
двухсотметровую=двухсотметроовую
де-гу-сти-фици-ровать=де-гу-сти-фициии-ровать
девушка все еще здесь=девушка всё еще здесь
девушка на ходу=девушка на ходуу
девяностолетним=девяностолеэээтним
девяностопроцентной=девяносто-процентной
девятиэтажке=девятиэтаажке
девять часов утра=девять часов утраа
дежурный связной =дежурный связноой 
дейли=дэйли
действую без ведома=действую без веэдома
делал все это=делал всё это
делалось все при помощи=делалось всё при помощи
дело далеко не хлопотное =дело далекооо не хлопотное 
дельфинчиками=дельфиинчиками
Денисенко=Денисеэнко
держа руки=держа руъки
дерьмо вывозить=дерьмо вывозииить
дерьмоволосой=дерьмоволооосой
десятизначных=десятизнааачных
десятикратно=десятикрааатно
десятилапых=десятилааапых
детенок=детёнок
Дешево цените=Дёшево цеэните
Джекиль=Джекииль
Джефферсон=Джеэфферсон
Джефферсона=Джеээфферсона
джин и виски=джин и виъски
джин-тоником=джин-тооником
Джонсона=Джоонсона
Джонсоном=Джоонсоном
Джонсону=Джоонсону
Джубили=Джуубили
Диамагнитность=Диамагнииитность
Диаса=Дииаса
Диккенсом=Дииккенсом
Дилантин=Дилантииин
Дилантина=Дилантиина
Дилантином=Дилантиином
Дирака=Диирака
дискуссии обо всем=дискуссии обо всём
дисциплинку=дисциплиинку
диффузирующую=диффузиирующую
ДК=Д-Каа
длинноватым=длинноваатым
для 10 похорон=для десяти похорон
для мечтающих в душе=для мечтающих в душеэ
для нашей проблемы=для наъшей проблемы
для неё чем-то большим=для неё чем-то боъльшим
для него самого=для него самовооо
для переработки хлопка=для переработки хлоъпка
для самого Императора=для самовооо Императора
для того существуют другие руки=для того существуют другие руъки
до 10 - 15 процентов=до десяти - пятнадцати процентов
до 80 - 85 лет=до восьмидесяти - восьмидесяти пяти лет
до велика =до велиика 
до завтрашнего утра=до завтрашнего утраа
до корней волос=до корней волоос
до самого трона=до самовооо трона
до самого утра=до самого утраа
до самой попки=до саъмой попки
до самой сухи=до самой сути
до этого руки не доходили=до этого руъки не доходили
добавил горячей=добавил горяъчей
добрался до самого=добрался до самовооо
добро пропадало=доброо пропадаало
добром и злом=доброом и злом
добывать на выборах голоса=добывать на выборах голосааа
доело-таки снега=доело-таки снегаа
доесть=доеэсть
дозаправка=дозапраавка
докрашивала=докраашивала
долго отскребет от стены=долго отскребать от стены
Долгоживущие=Долгоживуущие
Дома же анданорцев=Домаа же анданоорцев
Дома из коралла=Домаа из коралла
дома каменные=домаа каменные
дома побогаче=домаа побогааче
Дональдсон=Доональдсон
Донован=Доонован
Донована=Дооонована
Доноване=Доооноване
доновановский=дооооновановский
Доновановское=Дооновааановское
Донованом=Дооонованом
донце=доънце
дооккупационной=дооккупациоооонной
допил виски=допил виъски
дописывала=допиисывала
дописывают=допиисывают
допищал=допищааал
дополнительные сведения=дополнительные свеээдения
допустим такую любезность=допуустим такую любезность
дорические=дориические
Дормуа=Дормуаа
Дорога долгая=Дороъга долгая
дорога к Светлому Будущему=дороъга к Светлому Будущему
дорогой к подземке=дороъгой к подземке
дослушать все до завершения=дослушать всё до завершения
доспех=доспеэх
достала свечи=достала свеъчи
достань виски=достань виъски
достигали высоты=достигали высотыыы
достигают размерами козы=достигают размерами козыы
достижимых для них 25 километров =достижимых для них двадцати пяти километров 
Дотолкала=Дотолкаала
дошагали=дошагаали
дощечки на груди=дощечки на грудии
дравшиеся=драаавшиеся
Драгрон=Драгроон
древнее боли=древнеэе боъли
Дрейфуса=Дреэйфуса
друг в дружке=друг в друъжке
друг другом =друг друъгом 
других частей тела=других частей теъла
другой рукой металлическую змею=другой рукой металлическую змеюу
дубак=дубаак
дупелину=дупелиину
ДЪЛО=ДЕЛО
дыма и пыли=дыма и пыъли
Дьяволина=Дьяволиина
Дьяволиной=Дьяволииной
Дьяволину=Дьяволиину
Дьяволины=Дьяволиины
Дэвиса=Дээвиса
дюны пустынь=дюны пустыынь
дюшес=дюушес
дядя все знает=дядя всё знает
её глаза=её глазаа
её губы=её гуъбы
её лица коснулись руки=её лицаа коснулись руки
её руки=её руъки
Её руки=её руъки
евклидовская=евклиидовская
евреем-протезистом=евреем-протэзиистом
европейско-американской=европеэйско-американской
его в лесу =его в лесуу 
его приближенные=его приближённые
его самого арестуют=его самовооо арестуют
его самого повели=его самовооо повели
его самого тоже=его самовооо тоже
едим лишь=едиим лишь
едим свой хлеб=едиим свой хлеб
едим так=едиим так
еду готовить=едуу готовить
еду-питье=едуу-питьё
едят рыбу=едяат рыбу
ее губы=ее гуъбы
ее мечтой=ее меччтоой
ее моря=ее моряа
ее руки рефлекторно=ее руъки рефлекторно
ей все мало=ей всё мало
ей самой тяжело=ей самоой тяжело
ему платите втрое больше=ему плаатите втрое больше
епископальной=епископааальной
ериком=еэриком
Ерофей=Ерофеээй
Если уж на то пошло=Если уж на то пошлоо
Если узнает управляющий=Если узнаъет управляющий
ессильного=бессильного
есть во всем этом=есть во всём этом
есть дела частные=есть делаа частные
ехали верхом=ехали верхоом
ещё полно работы=ещё полноо работы
е„=её  
е„ глаза=её глазаа
е„ губы=её гуъбы 
е„ руки и ноги=её руъки и ноъги 
Ж4-21=Жэ 4-21
Ж5-21=Жэ 5-21
Ж6-21=Жэ 6-21
Ж6-22=Жэ 6-22
Жанвье=Жанвьеэ
жареностями=жаааареностями
жарковато=жарковаато
жаркое из скримликов=жаркоъе из скриимликов
ждала=ждалаа
ждала меня=ждалаа меня
желательнуо=желаательнуо
желдортерминологию=желдортерминолоооогию
Желенска-Рослова=Желенска-Роослова
желеобразную =желеобраазную 
желеподобной=желеподоообной
жигуленок=жигулёнок
жизненедеятельность=жизнедеятельность
жизнь самого Володи=жизнь самовооо Володи
Жилетт=Жилеэтт
Жиро=Жироо
жители разбегались=жители разбегаались
житий=жиътий
житье-бытье =житьё-бытье 
жопа с глазками=жопа с глаазками
жреческий=жреэческий
жреческого рода=жреэээческого рода
жреческом=жреэческом
Жюстен=Жюстеэн
за 15 минут=за 15 минуут
за все надо платить =за всё надо платить 
За все уплачено=За всё уплачено
за другим все четыре глаза=за другим все четыре глаъза
за моей спиной ноги=за моей спиной ноъги
за нашей гостьей=за наъшей гостьей
за овощами для салата=за овощаами для салата
за поворотом дороги=за поворотом дороъги
за спиной руки=за спиной руъки
за стоящим в нише=за стояъщим в нише
за считанные дни заводами Земли=за считанные дни заводами Землии
заблевала=заблеваала
забрала е„=забралааа её
забрала руку=забралааа руку
забудь все до тех пор=забудь всё до тех пор
забудьте все этот термин=забудьте всеъ этот термин
Забыла уже=Забыъла уже
заветные места ее тела=заветные места ее теъла
заводовладельцы=заводовладеэээльцы
заводские корпуса=заводсккиие корпусааа
завоевательским=завоеваательским
завяжешь глаза=завяжешь глазаа
завяжи себе глаза=завяжи себе глазаа
Загвар=Загваар
загородному бунгало=загородному бунгаъло
зададут нам жару=зададут нам жаъру
заделывал дыры=заделывал дыъры
задержало пору листопада=задержало поруу листопада
задрав ноги=задрав ноъги
зажурчал=зажурчааал
зазнобит=зазнобииит
зазубривание=зазууубривание
заиндевелого=заиндевеэлого
займи=займии
закадрить=закадрииить
закинув руки =закинув руъки 
заклекотав=заклекотаааав
заклиниванию=заклиииниванию
Закончилось бы все это=Закончилось бы всё это
закрепленная=закреплённая
закроет глаза=закроет глазаа
закрой глаза=закрой глазаа
закручивают гайки анданорцы=закручивают гайки анданоорцы
закрывал ворота=закрывал вороъта
закрывая глаза=закрывая глазаа
закрыл Володе глаза=закрыл Володе глазаа
закрыл глаза=закрыл глазаа
закрыла глаза=закрыла глазаа
закрытые веками=закрытые веэками
закупорила багажник=закупоорила багажник
зале полюсов мироздания=зале полюсооов мироздания
залили все водой=залили всё водой
залитованному=залииитованному
залихватски-разбойничий=залихваатски-разбойничий
зальчике=заальчике
замерцал=замерцааал
замерцала=замерцаала
замерцали=замерцаали
замечала пятна=замечала пяътна
замешкавшего=замеэшкавшего
замок Белоснежки=заъмок Белоснеэжки
замутненный=замутнённый
замыкавшему=замыкаавшему
замыкавший=замыкаавший
замыкайся=замыкаайся
заночует=заночуует
занудливая=зануудливая
заныло в груди=заныло в грудии
занялся подключением=занялсяаа подключением
заодно и узнаем=заодно и узнаъем
западло=западлооо
запаниковал=запаниковааал
запасы пищи=запасы пиъщи
запатистов=запатиистов
запах генерировало=заъпах генерировало
Запах жареных креветок=Заъпах жареных креветок
запах мыла=заъпах мыла
запах паленой резины=заъпах паленой резины
запах перегара=заъпах перегара
запах разложившейся крови=заъпах разложившейся крови
запах свежескошенной травы=заъпах свежескошенной травы
запах сделался чуть разреженнее=заъпах сделался чуть разреженнее
запах соборных свечей=заъпах соборных свечеэй
запах стирки=заъпах стирки
запах сырости=заъпах сырости
запах тления=заъпах тления
Запах шерсти=Заъпах шеърсти
запаха паленой резины=заапаха паленой резины
запаха тления=заапаха тления
запаха человечьей крови=заапаха человечьей крови
запахнуть полы =запахнууть полыы
заперла на семь замков=заперлааа на семь замков
запетляла=запетляала
запечатлена холодная жестокость=запечатленааааа холодная жестокость
запипикал=запипиикал
Заплачу тебе вдвое=Заплачуу тебе вдвое
заполночь=зааполночь
запорошены=запороошены
запрещено лет сорок назад=запрещеноооо лет сорок назад
запульнул=запульнууул
заразить болезнью самого Ктора=заразить болезнью самовооо Ктора
заросли ризофор =зааросли ризофор 
заросли скволыжника=зааросли скволыжника
зарулил=зарулииил
Засим=Засиим
заставил ее слова=заставил ее словаа
застывал на 15=застывал на пятнадцати
застыло на груди=застыло на грудии
засыпал безмятежным сном=засыпааал безмятежным сном
засыпал прямо в кресле=засыпааал прямо в кресле
засыпая и уже будучи=засыпаая и уже будучи
Засыпая на моём плече=Засыпаая на моём плечеэ
затарабанили=затарабаанили
затекшие=затёкшие
затененность=затенённость
затряс все отце сидевшую=затряс всё оътце сидевшую
заученные с первого раза слова=заученные с первого раза словаа
зафутболил =зафутбоолил 
Захват все новых=Захват всё новых
захват е„=захват её
захватывающе=захвааатывающе
заходил все дальше=заходил всё дальше
захолодало=захолодааало
Захрино=Заахрино
ЗАЧЕМ ВСЕ ЭТО=ЗАЧЕМ ВСЁ ЭТО
зачем так много проводов=зачем так много проводооов
зачесанные=зачёсанные
защищая глаза=защищая глазаа
звало и манило=зваъло и манило
звезды - не просто звезды=звёзды - не просто звёзды
ЗВЕРЬКИ=ЗВЕРЬКИи
здесь же все было=здесь же всё было
здорово изукрашенная=здоорово изукрашенная
Здравохранителей=Здравохраниителей
Зед-4=Зед 4
Зед-4 в 70 километрах=Зед четыре в семидесяти километрах
зеленному=зелённому
зеленоватой дымке=зеленоватой дыъмке
зеленоволосая=зеленоволооосая
зеленые стрекозы=зеленые стрекозыыы
землевладелице=землевладеэлице
землевладелицы=землевладеэлицы
землепроходец=землепрохооодец
землян не едим=землян не едиим
земной запах=земной заъпах
Зернов=Зерноов
ЗЕРО=зероо
златовласку=златовлааску
злых духов=злых дуъхов
змея перед прыжком=змеяа перед прыжком
знал все о Вителлий=знал всё о Вителлий
знатными родами=знатными родаами
знать все сильнее=знать всё сильнее
зов„т=зовёт
золотыми чешуями=золотыми чешуяами
Золушек=Зоолушек
Золушка=Зоолушка
Золушке=Зоолушке
Золушки=Зоолушки
Золушкой=Зоолушкой
Золушку=Зоолушку
Золя=Золяа
зомбировала=зомбиировала
зубками=зуубками
зубробизоны=зубробизоооны
ЗУБЦОВА=Зубцова
Зубцрва=Зубцова
и в чем же=и в чём же
и все они=и всеъ они
и все пятнадцать - компьютер=и всеъ пятнадцать - компьютер
И дома спокойны=И доъма спокойны
и лиса Алиса=и лисаа Алиса
и самого Владимира=и самовооо Владимира
играли до утра=играли до утраа
игрушенными=игрушечными
игры следовало=иъгры следовало
идеалистку=идеалииистку
идентификационную=идэнтификациооооооную
идентификационный=идэнтификациоооонный
ид„т=идёт
иерей=иереээй
из 10 высших богов=из десяти высших богов
из 100 великих богов=из ста великих богов
из 1000 служебных божеств=из тысячи служебных божеств
из 62 человек=из шестидесяти двух человек
Из бушующей грозовой бури=Из бушуующей грозовой бури
из жажды мести=из жажды меъсти
из которых торчали разноцветные провода=из которых торчали разноцветные проводааа
из нашей комнаты=из наъшей комнаты
из поместья вдовы=из поместья вдовыы
из сорока - пятидесяти слов=из сорока - пятиидесяти слов
из такого удушающе жаркого=из такого удушающе жааркого
из шлифованного=из шлифоованного
из языческих империй Земли=из языческих империй Землии
из-за деревьев леса не видно=из-за деревьев леъса не видно
из-за которой доносились голоса=из-за которой доносились голосааа
из-за туч пыли=из-за туч пыъли
изавтомата=из автомата
извертелась=извертеэлась
известковыми потеками стены=известковыми потеками стеъны
Извини - дела=Извини - делаа
извлекший=извлёкший
изгалялась=изгаляалась
изгиб дороги=изгиб дороъги
измазанные в крови=измазанные в кровии
измутузив=измутуузив
изумл„нно=изумлённо
изучения ЯП лица=изучения ЯП лиъца
изъгденным=изъеденным
Или это глаза=Или это глазаа
илота=пилота
Ильич=Ильиич
Ильичу=Ильичууу
им уже все известно=им уже всё известно
имеет в виду=имеет в видуу
имеете в виду=имеете в видуу
Имеется в виду=Имеется в видуу
имеется в виду=Имеется в видуу
имеешь в виду=имеешь в видуу
имей в виду=имей в видуу
имел в виду=имел в видуу
имела в виду=имела в видуу
Имелось в виду=Имелось в видуу
имею в виду=имею в видуу
имеют в виду=имеют в видуу
имея в виду=имея в видуу
импровизатора=импровизаатора
инвалидкой-уродиной=инвалиидкой-уродиной
инданорца=анданоорца
инопланетно=инопланеээтно
инопланетнымизамашками=инопланетными замашками
инструктажу=инструктажуууу
интервьюеров=интервьюуууеэров
интервьюируемого=интервьюууируемого
Интересант =Интересаааант 
Интернетом=Интэрнээтом
информарий=информаарий
инфохран=инфохрааан
инфохраны=инфохрааны
Ирак=Ираак
Искандера=Искандээра
Искандеры=Искандээры
испить еще и горечь=испить еще и гоъречь
исплевался =исплеваался 
испокон века были силлурийцы=испокон веъка были силлуриийцы
исполински=исполиински
иссушенная адовым солнцем дорога=иссуушенная аадовым солнцем дороъга
источенную ветрами и волнами=источенную веэтрами и воолнами
истрепанных=истрёпанных
исчезали из виду=исчезали из виъду
исчерканных=исчёрканных
их семью=их семьюу
Ихтиандр=Ихтиааандр
к 12 февраля=к двенадцатому февраля
к 1904 году=к тысяча девятьсот четвёртому году
к 9 мая =к девятому мая 
к нашему костру в лесу=к нашему костру в лесуу
к подобному видению ситуации =к подобному виииидению ситуации 
к самой дамбе=к самоой дамбе
к Самому Большому Начальнику =к Саамому Большому Начальнику 
к самому началу =к саамому началу 
к самому хвосту=к саамому хвосту
к самому худшему=к саамому худшему
кабестан=кабестааан
кабинетно=кабинеэтно
Каждая минута дорога=Каждая минута дорогааа
каждом шагу=каждом шагуу
казенности=казённости
как в тире=как в тиъре
как дела у тебя=как делаа у тебя
как и все гениальное=как и всё гениальное
как и Ринит=как и Ринаат
как провода соединять=как проводааа соединять
Как связной=Как связноой
Как соединять провода=Как соединять проводааа
как-нибудь=как-нибуудь
какая-нибудь=какая-нибуудь
какие именно части тела=какие именно части теъла
какие-нибудь=какие-нибуудь
каким-нибудь=каким-нибуудь
каких-нибудь=каких-нибуудь
какого-нибудь=какого-нибуудь
какое-нибудь=какое-нибуудь
какой были связаны мои руки=какой были связаны мои руъки
какой-нибудь=какой-нибуудь
каком-нибудь=каком-нибуудь
какому-нибудь=какому-нибуудь
какую-нибудь=какую-нибуудь
калачом=калачооом
калейдоскопически=калейдоскопииически
календарем=календарём
Каллиопы=Каллиоопы
каменно-рыжей=кааменно-рыъжей
Камера была уже включена=Камера была уже включенааа
Кампучии=Кампучиии
каннибализм=каннибалииизм
каннибальский=каннибаальский
кантональной=кантонаальной
кантональным=кантонаальным
капитанства=капитаанства
капорах=капоърах
капсулку-таблетку =каапсулку-таблетку 
Карабаса-Барабаса=Карабааса-Барабааса
каратистки=каратиистки
каратистских=каратиистских
Карашо=Карашооо
Кареглазка=Кареглаазка
Кареглазка-два=Кареглаазка-два
Кареглазке=Кареглаазке
Кареглазки=Кареглаазки
Кареглазкой=Кареглаазкой
Кареглазку=Кареглаазку
Карлсоне =Каарлсоне 
Карфагена=Карфагеэна
касается борта кружки=касается бортаа кружки
касалось его самого=касалось его самовооо
каталептической=каталептиической
катахреза=катахреэза
Катерина=Катериина
Катон=Катоон
Катя стояла=Каътя стояла
квазиисторической=квазиисторииической
квазикоэффициента =квази-коэффициента 
квазинаучная=квазинауучная
квест=квэст
квеста=квэста
квестов=квэстов
квинтильон=квинтильооон
Кеб=Кэб
кеб=Кэб
кеба=кэба
кельнерше=кёльнерше
кем-нибудь=кем-нибуудь
кибернетик=кибернээтик
кибернетике=кибернэтике
Кимова=Киимова
Кимовой=Киимовой
кина=кинаа
Кингстон=Киингстон
Кингстона=Киингстона
Кингстону=Киингстону
кинжалами зубов=кинжалами зубоов
кинокадров=кинокаадров
киносупермен=киносупермэээээн
киносъемочные=киносъёмочные
кислый запах пятна=кислый заъпах пятна
кистевых=кистевыыых
Клавдием=Клаавдием
Кладет что-то или берет=Кладет что-то или берёт
кладоискательский=кладоискаательский
кладоискательской=кладоискаательской
кластерный=клаастэрный
клацая=клаацая
Клеопатра =Клеопаатра 
клитора=клиитора
клиторы=клииторы
клубы пыли=клубы пыъли
Клубящийся мрак замер=Клубящийся мрак заъмер
клюговать=клюговааать
когда звезды - не просто=когда звёзды - не просто
когда узнает=когда узнаъет
когда-нибудь=когда-нибуудь
кого-нибудь=кого-нибуудь
Кодака=Коодака
кодирование=кодииирование
кодированию=кодииированию
кожухом=коожухом
колеса привычно громыхали=колёса привычно громыхали
коллоквиальная=коллоквиаальная
Колониальной=Колониааальной
колонну скорби=колонну скоърби
колоночками=колооночками
колоратурно=колоратууурно
колосс на глиняных ногах=коълосс на глиняных ногах
Колумбийском=Колумбиийском
кольца-колеса =коъльца-колёса 
командиршей=командииршей
командующёй=командующей
комбайнеры=комбайнёоры
комкали ткань простыни и впивались=комкали ткань простыниии и впивались
коммуникатор=коммуникааатор
коммуникаторах=коммуникааторах
Коммуникаторы=Коммуникааторы
коммуникаторы=Коммуникааторы
компани=коомпани
комплекс по поводу расизма=коъмплекс по поводу расизма
компьютерной сети=компьютерной сетии
Комсомольск=Комсомооольск
комсомольско-добровольческо-строительно-монтажной=комсомоольско-добровольческо-строительно-монтажной
комсомольско-корейское=комсомоольско-корейское
Кому-нибудь=Кому-нибуудь
кому-о=кому-то
конвульсивно=конвульсиивно
конголезцы=конголеэзцы
кондиционерки=кондиционеэээрки
конкистадоров=конкистадоооров
конструирования=конструиирования
конференц-вагон=конфереээнц-вагон
конференц-вагона=конфереээнц-вагона
концлагерные=концлаагерные
конча-а-а-ю-ю-ю-ю=конча-а-а-ю
коня под уздцы=коня под уздцыы
коричневато-серой=коричневаато-серой
коричневато-серыми=коричневааато-серыми
кормленой=коормленой
Корнхилла=Коорнхилла
коробкам=корообкам
коробками с лентами=короообками с лентами
королева наверняка отклонит прошение=королева наверняка отклоънит прошение
КОРОЛЕВА СКВИРЛОВ=КОРОЛЕВА сквирлов
Короткая стрижка пепельных волос=Короткая стрижка пепельных волоос
корпениями=корпеэниями
корпускулярность=корпускуляаарность
космоистребителем=космоистребииителем
космолет=космолёт
космолета=космолёта
космолетах =космолётах 
космолете=космолёте
космолетик=космолётик
космолетной=космолётной
космолетов=космолётов
космолетом=космолётом
космолетчица=космолётчица
космолеты=космолёты
космопорт=космопооорт
космопорта=космопоорта
косноязыкой=косноязыыыкой
коснувшись его груди=коснувшись его грудии
которого построена человеческая душа=которого построена человеческая душаа
которого самого следовало=которого самовооо следовало
которой кишмя кишат леса=которой кишмя кишат лесаа
которым я плачу=которым я плачуу
кофе в двух кружках=кофе в двух круъжках
кофейка=кофейкааа
Кофейком=Кофейкооом
кофейком=Кофейкооом
Краем уха=Краем уъха
краем уха=Краем уъха
красно-желтой=краъсно-желтой
красно-зелёная =краасно-зелёная 
красно-серыми=краъсно-серыми
краснофрачных=краснофраачных
красный и зеленый тона=красный и зеленый тонаа
красоте невзрачной средней полосы=красоте невзрачной средней полосыыы
красотой черт=красотой чеърт
кратенький=краатенький
кратенько=краатенько
Кремлем=Кремлём
кремово-бежевую =креэмово-бежевую 
кривя губы =кривя гуъбы 
кримлика=криимлика
Кристиана=Кристиаана
критское=криитское
кровавые тона=кровавые тонаа
кроветворение=кроветвореэние
кровопотери=кровопотеээри
кровянисто-химическим=кровяниисто-химическим
крокодильей=крокодиильей
крокодильи=крокодиильи
Кромвелем=Кроомвелем
кроме минут близости=кроме минуут близости
Кромсаешь статью =Кромсаешь статьюу 
Кругом был туман=Кругоом был туман
кругом было бы разлито=кругоом было бы разлито
Кругом синел океан =Кругоом синел океан 
кругом суетились полицейские=кругоом суетились полицейские
кружила высоко=кружила высокооо
кружными=кружныыми
Крук и Тони=Крук и Тоъни
крупнокалиберник=крупнокалииберник
крутанула=крутануула
крутобокой=крутобоокой
крутости=круутости
крыло популистов=крылоо популистов
Крыму=Крымуу
Крышечка=Крыышечка
крышечки=крыышечки
Ксенофонта=Ксенофоонта
Ксенофонтом=Ксенофоонтом
Кто меня узнает=Кто меня узнаъет
кто на чем=кто на чём
кто ни попадя=кто ни поопадя
кто стоит у дверей=кто стоиит у дверей
Кто-нибудь=Кто-нибуудь
кто-нибудь=Кто-нибуудь
куда как большим количеством слов=куда как боъльшим количеством слов
куда-нибудь=куда-нибуудь
культуристок=культуриисток
кулямб=куляамб
кулямбовое=куляамбовое
купе-отсека=купээ-отсека
куртаж=куртааж
кусала губы=кусала гуъбы
кусая губы=кусая гуъбы
куснул=куснуул
кучерском=кучерскооом
кучу-малу=кучу-малуу
кхе-гм-м-ммм=кхе-хыммммм
кюрасо и виски=кюрасо и виъски
лаборанты=лабораанты
лабуду=лабудууу
лавровом=лавроъвом
лагеря вторгнутся=лаагеря вторгнутся
Лаину=Лайну
Лакемайнен=Лакемаайнен
Лансье=Лансьеэ
Ланфиер=Ланфиеээр
Ланьер=Ланьеэр
Лапидюса=Лапидюуса
лапутян=лапутяаан
лапутяне=лапутяане
Лаудер=Лааудер
лгущего=лгуущего
ле-5 тучие мыши=летучие мыши
ЛЕ-Е-ЕЙЛА-А-ААА=Лееейлаааа
левом плече=левом плечеэ
легеньких=лёгеньких
легли ей на плечи=легли ей на плеъчи
лезвия своих зубов=лезвия своих зубоов
Леиной=Леэиной
лейлино=леэйлино
лейлиному=леээйлиному
лейлину =леээйлину 
лейлины=леэйлины
лекторше=леэкторше
Леней=Лёней
Ленно=Леэино
Ленного=Леэнного
Леню=Лёню
Леня=Лёня
лет 8-9=лет восьми-девяти
летающих столоначальников и триединого Лица=летающих столоначальников и триединого Лицаа
лжепопулиста=лжепопулиииста
лжепророков=лжепророоков
Либерасьон=Либерасьоооон
Лиса Алиса=Лисаа Алиса
лица неведомых профессий =лиъца неведомых профессий 
ллвреях=ливреях
лобка=лобкаа
лобок=лобоок
логотипом=логотиипом
ломали копья=ломали коъпья
ломать копья=ломать коъпья
ломая головы=ломая гоооловы
ломившихся напролом поперек тропы=ломившихся напролом поперек тропыы
лопастей двух огромных=лопастеээй двух огромных
Лос-Анджелес=Лос-Аанджелес
Лос-Анджелеса=Лос-Ааанджелеса
лос-анджелесского=лос-аааанджелесского
лос-анджелесской=лос-ааанджелесской
лос-анджелесском=лос-ааанджелесском
Лоховский пер дом 42 каб=Лоховский переулок дом 42 кабинет
лошадиные количества пищи=лошадиные количества пиъщи
лошадях=лошадяаах
Лужниках=Лужникааах
Лужники=Лужникиии
лучше его самого=лучше его самовооо
лучшие сыны=лучшие сыныы
Любит горы=Любит гоъры
люди все шли=люди всё шли
люди самого Флинта=люди самовооо Флинта
Людочка=Люудочка
Людочкина=Люуудочкина
Людочкино=Люуудочкино
Людочку=Люудочку
Люлечки=Люулечки
люминофорного=люминофоорного
Люнэ=Люнээ
Люпину маму=Люупину маму
лязганьем =ляазганьем 
М-22=М 22
М-да=Мдаааа
М-м-м=Хыммм
М-м-ммм =Хымммм
М-м-мммм=Хымммм
М-м-ммммм=Хыммммм
М-м-мффф=Хымммффф
м-оо-й=моо-й
М21Б=М21 бэ
Маа-м=Маам
Магдалины=Магдалиины
Магелланы=Магеллааны
магнитные бури=магнитные буъри
магнитобиология=магнитобиолоооогия
Мадеро=Мадэро
Мазохистку=Мазохиистку
Майн-Айленда=Майн-Аайленда
маклерские=маааклерские
маклерских=мааклерских
маклерского=маааклерского
маклерское=маааклерское
малоазийские =малоазиийские 
малоазийские земли=малоазиийские зеъмли
малоинформативным=малоинформатиииивным
малопривлекательной=малопривлекааательной
малосимпатичного=малосимпатииичного
малосимпатичным =малосимпатиииичным 
малосъедобная=малосъедообная
мануале=мануаале
марать руки=марать руъки
Марго =Маргоо 
МАРГО-О-О=Маргооооо
Марианн=Мариааанн
марк-твеновская=марк-твэээновская
марктвеновский=марктвэновский
марктвеновском=марктвэновском
мартиновский=мааартиновский
Марцелл=Марцеэлл
Маршак=Маршаак
марьяж=марьяаж
масляно-розового=маасляно-розового
мастера выпытывать показания =мастерааа выпытывать показания 
мастеровщинка=мастеровщииинка
мат-обеспечение=мат-обеспечеэние
математизации=математизааации
матери телеграмму не отбил =маатери телеграмму не отбил 
машиностроительном - все то же=машиностроительном - всё то же
маячок-стимулятор=маячок-стимуляатор
МГУ=эм-гэ-уу
мебелишку=мебелиишку
меблированную=мебелированную
межвагонной=межвагоонной
между разными родами=между разными родаъми
межнационально=межнационаааально
Мезон=Мезоон
Мейера=Меэйера
мелкими коробками=мелкими короъбками
мелодраматически=мелодраматииически
мен=мэн
меновой=меэновой
меновом=меэновом
Мердока =Меэрдока 
Мердоке=Меэрдоке
мердоковских=меээрдоковских
мердоковской=меээрдоковской
Мердоком=Меэрдоком
Мердоку=Меэрдоку
мертвенно-синим=мертвенно-сииним
Мертвые сраму не имут=Мертвые сраму не имуут
мескаль=мескааль
метаболизм=метаболиииизм
металлические жилы защитника лагеря=металлические жилы защитника лаагеря
метафорично=метафорииично
Метели-1=Метели 1
Метель-1=Метель 1
Метелью-1=Метелью 1
методы ведения боя=меэтоды ведеъния боя
методы и результаты=меэтоды и результаты
методы наивны и неточны=методы наивны и нетоъчны
механики узнают о цели=механики узнаъют о цели
Мечтой=Меччтоой
мечты сбылись=мечты сбылиись
ми-нкагюрнее=миниатюрнее
Микатоник=Микатооник
Микки-Мауса=Микки-Маауса
микроволновая печь=микроволноваааая печь
микродолей =микродоолей 
микроизлучатели=микроизлучааатели
миллионщик=миллиоонщик
мимоходный=мимохоодный
минералки=минераалки
минералкой=минераалкой
минувшими=минуувшими
Минут за десять=Минуут за десять
минут за десять=Минуут за десять
Минут за сорок=Минуут за соърок
минут на сорок=минуут на соърок
минут через двенадцать=минуут через двенадцать
Минут через десять=Минуут через десять
Минье=Миньеэ
Миньер=Миньеэр
МИРЛИ=мирли
мм-ии-лл-ыы-ййй=мииллыый
мне надо передохнуть=мне надо передохнууууть
мне самой пришлось=мне самоой пришлось
Мне уже все равно=Мне уже всё равно
мнение других подразделений мне глубоко=мнение других подразделений мне глубокооо
многоголосьем=многоголооосьем
многозарядные=многозаряадные
Многонаселенного=Многонаселённого
многоногий=многоноогий
моёй=моей
моглось=моглоось
моделирование=модэлиирование
моделированием=моделиированием
моделирования=модэлиирования
модных людей страны=модных людей страныы
можно и должно=можно и доължно
можно сделать почти все=можно сделать почти всё
мозолящим глаза=мозолящим глазаа
Моиза=Мооиза
Моисеем=Моисеэем
Моисей=Моисеээй
Мой лоб начал потеть=Мой лоб наъчал потеть
мокрые волосы касались моей груди=мокрые волосы касались моей грудии
молитвослов=молитвослоооов
молитвослову=молитвослооову
молодежно-подъездно-уличную =молодёжно-подъездно-уличную 
молчание самого космоса=молчание самовооо космоса
морганы  =мооорганы  
мордасовско-зыкинским=мордасовско-зыыкинским
мордобоем=мордобооем
морозильно-защитного=морозиильно-защитного
мортуса=моортуса
морщились и пили=морщились и пиъли
Мосгортранс=Мосгортрааанс
Мосина=Моосина
мотылек=мотылёк
мохжет=может
Моцарта=Мооцарта
мошеннически=мошеэннически
Моя Акварина=Мояа Аквариина
моя знакомая=мояа знакомая
Моя или всех моих=Мояа или всех моих
мо„ полотенце=моё полотенце
мраморно-белая=мрааморно-белая
мужчиной лет сорока =мужчиной лет сорокааа 
Муссолини=Муссолиини
Мухачева=Мухачёва
Мухачеве=Мухачёве
мухинской=муухинской
МЦП-6МЗ=МЦП 6МЗ
МЦП-6МР=МЦП 6МР
мы при чем=мы при чём
мы проследили взглядами облачка=мы проследили взглядами облачкааа
мы стоим на Земле=мы стоиим на Земле
мы уже за городом=мы уже за гооородом
мывшему руки=мывшему руъки
мыслеблок=мыслеблооок
Мыслесмерти=Мыслесмеэрти
Мыслесмерть=Мыслесмеээрть
мысль о его мести=мысль о его меъсти
мыть руки=мыть руъки
мыть стекла=мыть стёкла
Мэдисон=Мээдисон
Мэрдоку=Мээрдоку
Мюнхгаузена=Мюнхааузена
Мюррэ=Мюррээ
Н-да=Нда
н-о-ч-и =ночи
на 14 января =на четырнадцатое января 
на 24 часа=на 24 часаа
на Анданоре сказочной луны=на Анданооре сказочной луныы
на балконе обесчещенного города=на балконе обесчещенного гооорода
на берег прибыли =на беърег прибыли 
на вершине горы=на вершине горыы
на виду у всего отряда=на видуу у всего отряда
на виду у всей=на видуу у всей
на виду у голодных=на видуу у голодных
на все было глубоко наплевать=на всё было глубоко наплевать
на все плюнула=на всё плюнула
на все согласную=на всё согласную
на всем своем протяжении=на всём своем протяжении
на всем Силлуре=на всём Силлуре
на всем скаку=на всём скаку
на газетные полосы=на газетные поолосы
на горе было слышно=на гореэ было слышно
на густой синьке моря=на густой синьке моъря
на дне Города=на дне Гоорода
на дне реки=на дне рекии
на древнюю руну=на древнюю руъну
на другом конце города=на другом конце гоорода
на душе будет полегче=на душеэ будет полегче
на залитую светом прожекторов=на зааалитую светом прожектороооов
на золотом ковре осеннего леса=на золотом ковре осеннего леъса
На каменной ограде у ворот=На каменной ограде у вороот
на карнизе соседского дома=на карнизе соседского доъма
на клочке земли=на клочке землии
на лету=на летуу
на медленном ходу=на медленном ходуу
на месте некогда величественного города=на месте некогда величественного гооорода
на мо„м плече=на моём плечеэ
На нашей базе=На наъшей базе
на нашей базе=На наъшей базе
на нашей планете=на наъшей планете
на нашей стороне реки=на наъшей стороне рекии
на нашем коротком веку =на нашем коротком векуу 
на оголенной раме окна=на оголенной раме окнаа
на окраине леса=на окраине леъса
на первом же глотке=на первом же глоткеэ
на плече висел=на плечеэ висел
на плечи и руки=на плеъчи и руъки
на подлете к столице=на подлёте к столице
на полном серьезе=на полном серьёзе
на полном ходу=на полном ходуу
на пороге нашего дома=на пороге нашего доъма
на пороге номера=на пороге ноомера
на правом плече=на правом плечеэ
на радаре живого места=на радаре живого меъста
на ремонте стоят=на ремонте стояат
на рытвинах дороги=на рытвинах дороъги
на самого себя=на самовооо себя
на самой просеке=на самоой просеке
на самом волнующем месте=на саъмом волнующем месте
на самом гребне счастья=на саъмом гребне счастья
на самом деле=на саъмом деле
на самом деле нет=на саъмом деле нет
На самом деле рельсы=На саъмом деле рельсы
на самом же деле=на саъмом же деле
на самом фешенебельном отрезке=на саъмом фешенебельном отрезке
На самом-то деле=На саъмом-то деле
на своей роскошной груди руки=на своей роскошной груди руъки
на своем веку=на своем векуу
на сво„м носу=на своём носуу
на сероватом мраморе стены=на сероватом мраморе стеныы
на сорок втором километре=на соърок втором километре
на стене дома=на стене доъма
на стоящего за его спиной=на стояащего за его спиной
на стоящий в углу =на стояащий в углу 
на сухом дне реки=на сухом дне рекии
на уровне двадцатого века =на уровне двадцатого веъка 
на утоптанном пятачке снега=на утоптанном пятачке снеъга
на фоне лица=на фоне лицаа
на ходу бросила=на ходуу бросила
на ходу заскочил=на ходуу заскочил
на ходу натягивая=на ходуу натягивая
На ходу поправляя=На ходуу поправляя
на ходу разглядывающими =на ходуу разглядывающими 
на чьем счету=на чьем счетуу
на шесть часов вечера=на шесть часов веэчера
на электронике особого рода =на электронике особого роъда 
над головой руки=над головой руъки
над её макияжем=над её макияажем
над мудреным имечком=над мудреным иимечком
над просветом в лесу=над просветом в лесуу
надув губы=надув гуъбы
надув щеки=надув щёки
Назарета=Назареэта
назвать статью=назвать статьюу
наземных сил противника до 13=наземных сил противника до тринадцати
называть тренажерами=называть тренажёрами
называют Атиллой Юга=называют Атиллой Юъга
наивнимательно=наивнимаательно
наизусть все Пятикнижие=наизусть всё Пятикнижие
наименование крыла=наименование крылаа
найдено - все целиком=найдено - всё целиком
Найткастлы=Наайткастлы
накипи=наакипи
накормленных лошадей=накормленных лошадеээй
налитые молочной нежностью женские груди=налитыые молочной нежностью женские груди
наносное=наносноое
наобщаться=наобщааться
наодеколоненным=наодеколоооненным
Наперехват=Наперехваааат
наподдала=наподдаала
напоенные соком=напоённые соком
наполняя лица и сердца=наполняя лиъца и сердцаа
направленным все на то же=направленным всё на то же
наркеты=наркоты
наркоторговля=наркоторгооовля
народами Земли осыпались=народами Землии осыпались
наряду с прочим барахлом=нарядууу с прочим барахлом
наряду с уже действующими=нарядууу с уже действующими
настругал сыра=настругааал сыра
насчёт тебя самой=насчёт тебя самоой
научно объяснено=научно объясненоооо
нафантазировав=нафантазиировав
находились далеко=находились далекооо
находящихся над изгибом реки=находящихся над изгибом рекии
нацепив шлем =нацепив шлеъм 
националистка=националииистка
начал было=наъчал было
начал было вновь=наъчал было вновь
начала блаженно жмуриться=началааа блаженно жмуриться
начала взятие=началааа взятие
начала говорить=началааа говорить
начала ласкать=началааа ласкать
начала манёвр=началааа манёвр
начала пробивать=началааа пробивать
начала пульсировать =началааа пульсировать 
начала с трусиков=началааа с трусиков
начала сопротивляться=началааа сопротивляться
начала тихонько=началааа тихонько
началось все с беспокойства=началось всё с беспокойства
начеркано=начёркано
наш стоит посреди=наш стоиит посреди
нашаривая=нашааривая
нашей базы=наъшей базы
нашей бригаде=наъшей бригаде
нашей бригады=наъшей бригады
нашей встречи=наъшей встречи
нашей гостьей=наъшей гостьей
нашей командирши=наъшей командиирши
нашей лоботомии=наъшей лоботомии
нашей любви=наъшей любви
нашей первой миссии=наъшей первой миссии
нашей разведке=наъшей разведке
нашей Родиной=наъшей Родиной
нашей территории =наъшей территории 
не больше 110 фунтов=не больше ста десяти фунтов
не боящиеся воды=не боящиеся водыы
Не все же тебе=Не всё же тебе
не все ли равно =не всё ли равно 
не все они горбаты=не всеъ они горбаты
не все сказал=не всё сказал
не выпустит нас из виду=не выпустит нас из виъду
не выходите до утра=не выходиите до утраа
не вьет здесь гнезда=не вьет здесь гнёзда
не дожидаясь утра =не дожидаясь утраа 
не знает и не узнает=не знает и не узнаъет
не знает ни фига=не знает ни фигаа
не имеем права рисковать=не имеем праъва рисковать
не имеете права=не имеете праъва
не имел права=не имел праъва
не имел права принимать=не имел праъва принимать
не имел права сказать=не имел праъва сказать
не имею права рисковать=не имею праъва рисковать
не коли же ты=не колии же ты
Не лица - маски=Не лиъца - маски
не менее пяти проводов=не менее пяти проводооов
не менее сорока на вид=не менее сорокааа на вид
Не ней большими буквами=На ней большими буквами
не ночует дома=не ночуъет дома
не остается в долгу=не остается в долгуу
не осталась в долгу=не осталась в долгуу
не отключили - потоком воды=не отключили - потоком водыы
не покупает пока голоса избирателей=не покупает пока голосааа избирателей
не пристегнут к броне ворота=не пристёгнут к броне воооорота
не развернулось и не спало=не развернулось и не спаъло
не скажет все до конца=не скажет всё до конца
не смогут вести=не смогут вестии
не совершенный им поступок=не совершённый им поступок
не стоит на месте=не стоиит на месте
не считая пятна=не считая пяътна
не узнав все до конца=не узнав всё до конца
не узнает всю обстановку=не узнаъет всю обстановку
не узнает истину=не узнаъет истину
Не уместилось все в одну=Не уместилось всё в одну
Не уплывайте далеко=Не уплывайте далекооо
не учесть прошлого=не учеъэсть прошлого
не-дели=недели
Не-е-ет=Нееет
невместимой=невместиимой
невымытую=невыымытую
невысокие строения того же цвета=невысокие строения того же цвеъта
недалеко от места=недалекоооо от места
недалеко от моего лица=недалекоооо от моего лица
неджентльменском=неджентльмеэнском
недодумав=недодуумав
недозревшей=недозреэвшей
недообглоданный=недообглооданный
недооценено=недооцеэнено
недоучиваются=недоууучиваются
нежданно-густыми и теплыми тонами=нежданно-густыми и теплыми тонаъми
нежно-зеленые тона =нежно-зеленые тонаа 
Незагипнотизированная=Незагипнотизиированная
незаемные=незаёмные
незаинтересованно=незаинтересоооованно
незаменимость=незаменииимость
незапятнан=незапяатнан
незло=незлоо
Незнаемое=Незнааемое
неизящной=неизяащной
неистинности=неиистинности
некоторая неровность пола=некоторая неровность поъла
некрофильской=некрофиильской
нематематику=нематемаатику
Нембутал=Нембутааал
немереные=немеэреные
немного в стороны =немного в стоороны 
немного поем=немного поеэм
необжита =необжиита 
необидно=необиидно
необидной=необиидной
неогалунщикам=неогалуунщикам
неогалунщиков =неогалуунщиков 
неограниченного кредита=неограниченного кредиъта
неопасен=неопаасен
неопровергнутый=неопровеэргнутый
неоригинален=неоригинаааален
неотпиранием=неотпираанием
неохраняемой=неохраняаемой
непережитом=непережииитом
непечатно=непечаатно
неполадка=неполаадка
непонимайку=непонимааайку
непонимающий=непонимаающий
непонимающим =непонимаающим 
Непострадавший=Непострадааавший
непрерванности=непреэрванности
неприятный запах=неприятный заъпах
непроглатываемый=непроглаатываемый
непроглядность=непрогляадность
непродажные голоса=непродажные голосааа
непрофессиональна=непрофессионаальна
непрошеная=непроошеная
непрошеного=непроошеного
неразбериха во всем=неразбериха во всём
неразличимый запах духов=неразличимый заъпах духов
нерешенные проблемы страны=нерешенные проблемы страныы
несвязанного=несвяазанного
несделанные=несдеэланные
несделанные дела=несдеэланные делаа
несекретным=несекреэтным
несказанными=нескаазанными
несмазанными=несмаазанными
несмотря на двадцать три голоса=несмотря на двадцать три гоолоса
несогласны=несоглаасны
несопротивлявшихся=несопротивляаавшихся
несуетливо=несуетлиииво
Несущего-1=Несущего 1
несущегося высоко- высоко над землёй=несуущевося высокооо- высокооо над землёй
Несущий-1=Несущий 1
Несущим-1=Несущим 1
Нет повести печальнее=Нет поовести печальнее
нет права голоса=нет праъва голоса
нетесаных =нетёсаных 
неудержимостью=неудержиимостью
неузнаванья=неузнавааанья
нехудосочных=нехудосооочных
нечто=неччто
ни в чем=ни в чём
ни дороги к нему=ни дороъги к нему
ни капли виски=ни капли виъски
ни на чем=ни на чём
ни о чем=ни о чём
ни при чем=ни при чём
ни треска попавшей под ногу=ни треъска попавшей под ногу
ни уха ни рыла=ни уъха ни рыла
ни фига не понимала=ни фигаа не понимала
ни хрена не стоят=ни хренаа не стояат
ни черта граждане=ни чертаа граждане
ни черта не видел=ни чертаа не видел
ни черта не получалось=ни чертаа не получалось
нижеописанной =нижеопиисанной 
низводя=низводяаа
никого кругом не было=никого кругоом не было
но все новое=но всё новое
но все равно=но всё равно
но все такой =но всё такой 
но ни купе=но ни купээ
Но никто кругом=Но никто кругоом
Но с нашей=Но с наъшей
но стопы=но стоъпы
Но толку от большинства=Но тоълку от большинства
новианки=новиаанки
новианские=новиаанские
новианской=новиаанской
новооткрытых=новооткрытыыых
новоприобретенным=новоприобретённым
новым шприцем=новым шприцём
ноги - от ушей=ноъги - от ушей
ноги бы тебе=ноъги бы тебе
ноги в руки=ноъги в руки
ноги выше колена=ноъги выше колена
Ноги девушки=Ноъги девушки
ноги Леи=ноъги Леи
ноги противно ослабли=ноъги противно ослабли
Ноги хоть и плохо=Ноъги хоть и плохо
ноги этой модели=ноъги этой модели
ноготочкой=ноготоочкой
номера экипажа не запомнил=номерааа экипажа не запомнил
носил на виду=носил на видуу
ноутбука=ноутбуука
ноутбуку=ноутбууку
нравился этот запах=нравился этот заъпах
Ну и методы=Ну и меэтоды
нуар=нуаар
нувориш=нувоъриш
нужны и связные=нужны и связныые
нулем=нулём
нуте-шествовали=путешествовали
нью-йоркские=нью-йооркские
нью-йоркскими=нью-йооркскими
нью-йоркского=нью-йооркского
Нью-Терриконов=Нью-Террикоонов
Ньюком=Ньюкоом
нянькаться=няанькаться
о вас потрохов=о вас потрохооов
о вашем подразделении узнают=о вашем подразделении узнаъют
о глотке виски=о глоткеэ виъски
О чем=О чём
о чем =О чём 
о чем-то=О чём-то
О ч„м =О чём 
О-А-С=Оо-Аа-эС
об руки=об руъки
об упокоении ее души=об упокоеэнии ее души
об этом мы тоже узнаем=об этом мы тоже узнаъем
оба стоят в скучной тишине=оба стояат в скучной тишине
оббив=оббиив
обведенный=обведённый
обвила мою шею =обвилааа мою шею 
обгладывая ребра=обгладывая рёбра
обговоренное=обговорённое
обе свои руки=обе свои руъки
обездвижен=обездвиижен
обезьяньей=обезьяаньей
обеспечить нужды =обеспечить нуъжды 
обжористого=обжоористого
обитая жестью=обиитая жестью
обкушенные=обкуушенные
облаке пыли=облаке пыъли
облако пыли=облако пыъли
облаком своего запаха=облаком своего заапаха
облачко пыли=облачко пыъли
обнаружил в лесу=обнаружил в лесуу
обо всем=обо всём
обо всем говорили=обо всём говорили
Обо всем знал=Обо всём знал
обо всем этом=обо всём этом
Обобщенность=Обобщённость
ОБОЗРИМОГО=обозримово
оборвалось все=оборвалось всё
обраставшими все новыми подробностями=обраставшими всё новыми подробностями
обрастающего все новыми=обрастающего всё новыми
обратно все то=обратно всё то
оброненной=обронённой
обрыдл=обрыыдл
обстриг=обстрииг
обтрепанными =обтрёпанными 
обустройства=обустроойства
обустройство временного лагеря=обустроойство временного лагеря
Общественность Города узнает правду=Общественность Города узнаъет правду
Объединённых Наций Земли=Объединённых Наций Землии
Объединенные силы Земли=Объединенные силы Землии
объемы пищи=объемы пиъщи
обязательно признает ведущую политическую роль=обязательно признаъет ведущую политическую роль
обятия=объятия
овевало=овеваало
оглоед=оглоеээд
оглоедок=оглоеэдок
оглоеды=оглоеэды
оглядывается на стоящего=оглядывается на стояащего
огонечками=огонёчками
одаряя тонкими мазками=одаряая тонкими мазками
одних так далеко=одних так далекооо
одного из 256=одного из двухсот пятиидесяти шести
одноименного=одноимённого
однообразием своим пищи=однообразием своим пиищи
однослойный=однослоойный
одноэтажностью=одноэтаажностью
одноэтажностью вилл=одноэтаажностью вил
ожгло=ожглоо
ожерелье и серьги=ожерелье и сеърьги
Ойлера=Оойлера
Ойлере=Оойлере
ойлерской=оойлерской
оказалась права - оба раза =оказалась праваа - оба раза 
оказался даже большим анданорцем=оказался даже боъльшим анданоорцем
оказаться враньем=оказаться враньём
океаны и моря=океаны и моряа
Оккупантка=Оккупаантка
оккупантка=Оккупаантка
оккупантше=оккупаантше
Окна рабочей резиденции=Оъкна рабочей резиденции
окна распахнутыми=оъкна распахнутыми
окна топливной станции=оъкна топливной станции
около 200 килобайт=около двухсот килобайт
около 80 земных лет=около восьмидесяти земных лет
околоанданорском=около анданоорском
окрасили золотом=окрасили зоолотом
окрестные поселения далеко=окрестные поселения далекооо
окрещука=окрещуука
окрыленно=окрылённо
олимпийства=олимпиийства
он все же сообщит=он всё же сообщит
он все не приходил =он всё не приходил 
он все равно=он всё равно
он все это тогда=он всё это тогда
он лег на то место=он лёг на то место
он пробегает его=он пробегаает его
он уже звонит в квартиру=он уже звоънит в квартиру
она вообще стоит вертикально=она вообще стоиит вертикально
она далеко=она далекооо
она его узнает=она его узнаъет
она получше узнает=она получше узнаъет
она уже шустро=она уже шуъстро
она узнает за=она узнаъет за
они аплодировали =они аплодиировали 
они бы все равно говорили=они бы всё равно говорили
они и сами узнают=они и сами узнаъют
они постоянно разбегались =они постоянно разбегаались 
они тоже этим занялись=они тоже этим занялииись
они тут все налаживали=они тут всё налаживали
опершись=опёршись
опийный=ооопийный
опостьшевшей =опостылевшей 
определить нашей дружеской =определить наъшей дружеской 
опрокинула е„=опрокинула её
опупев=опупеээв
опупеть=опупеээть
опускаю ноги=опускаю ноъги
опустив ноги=опустив ноъги
опустив руки=опустив руъки
опутанный проводами=опутанный проводаами
опутывала себе ноги=опутывала себе ноъги
опьяняя=опьяняая
орбиталь=орбитаааль
орбиталях=орбитаалях
оргазменное=оргаазменное
орган не екает=оърган не екает
органы чувств=оорганы чувств
ОРО=оро
Осборна=Оосборна
Осборне=Оосборне
Осборном=Оосборном
Осборну=Оосборну
осваивать глубины=осваивать глубиины
Освальда=Оосвальда
освобождая руки=освобождая руъки
ослабить бурю=ослабить буЪрю
основе крепкого правительства стоит армия=основе крепкого правительства стоиит армия
особенно высоко=особенно высокооо
Особого 1 штурмового=Особого первого штурмового
осоловелой=осоловеээлой
оставалось все меньше=оставалось всё меньше
оставив губы=оставив гуъбы
оставить все как есть=оставить всё как есть
оставляет пятна=оставляет пяътна
остался далеко=остался далекооо
останавливается уже примстившийся=останавливается уже примеэтившийся
остановились передохнуть=остановились передохнууууть
остренькие=ооостренькие
остров все уменьшался=остров всё уменьшался
острозубые пасти=острозубые паъсти
осыпали друг друга влюбленные=осыпаали друг друга влюбленные
Осыпающие=Осыпаающие
осыпаясь=осыпааясь
от его туши=от его туъши
От кого он узнает=От кого он узнаъет
от мертвых тел вод озера=от мертвых тел вод оозера
от нашей организованности=от наъшей организованности
от просившейся на губы=от просившейся на гуъбы
от руки самого Императора=от руки самовооо Императора
от шерстяных свитеров=от шерстяных свитэрооов
от этой самой плазмы=от этой саъмой плазмы
от этой стрекозы=от этой стрекозыыы
отбросив все мешающее=отбросив всё мешающее
отбыли для подробного доклада=оотбыли для подробного доклада
отвезли в клинику доктора=отвезли в клинику дооктора
отвел глаза=отвел глазаа
отвела глаза=отвела глазаа
отвести глаза=отвести глазаа
отвлекшейся=отвлёкшейся
отвлекшись=отвлёкшись
отводил глаза=отводил глазаа
отводя глаза=отводя глазаа
отдав голоса=отдав голосааа
отдадим тогда голоса=отдадим тогда голосааа
отдать Мердоку голоса=отдать Меэрдоку голосааа
отдельно стоящие дома=отдельно стояъщие домаа
Отелло=Отэлло
отельный быт=отэльный быт
откликнувшиеся=отклииикнувшиеся
откол=откоол
Откройте глаза=Откройте глазаа
открыв глаза =открыв глазаа 
открывалкой-брелоком=открываалкой-брелоком
открыл глаза=открыл глазаа
открыла глаза=открыла глазаа
открыть глаза=открыть глазаа
откуда мы узнаем=откуда мы узнаъем
откуда ни попадя =откуда ни поопадя 
Откуда он узнает=Откуда он узнаъет
откуда они узнают=откуда они узнаъют
Откуда это все и зачем=Откуда это всё и зачем
отложить до утра=отложить до утраа
отмазывайся=отмаазывайся
отморозок=отмороозок
отпускающего на нее большие средства=отпускающего на нее большие средстваа
отравленной соли=отравленной соъли
отраженности =отражённости 
отряд уэртистов=отряд уэртиистов
отскребываться=отскрёбываться
отсоединил компьютер от сети =отсоединиил компьютер от сетии 
отсоединишь=отсоединииишь
отстраненно=отстранённо
отстрелив=отстрелииив
Отстрелил=Отстрелииил
отстрелила=отстрелиила
отсыпаясь=отсыпааясь
отчленил=отчленииил
отшибить=отшибииить
отшибить шлем=отшибииить шлеъм
отщелкала=отщёлкала
отыщет черта=отыщет чёрта
офисной=оофисной
официанткины=официаанткины
официанточка=официаанточка
ОФФИС=Оффис
Ох-х-ххх=Оххххх
охами=ооохами
оцифровку=оцифроовку
оч-ч-чень=очччень
очарованье=очаровааанье
очищал статью=очищал статьюу
ошметьях волос=ошметьях волоос
П-1=П 1
пали ей на плечи=паъли ей на плеъчи
палит все сильнее =палит всё сильнее 
палочно-засовочная =паалочно-засоовочная 
панночка=паанночка
папенек=паапенек
пара минут=пара минуут
парализатора=парализаатора
парализующе-томным=парализуующе-томным
параноидальная=параноидааальная
пареностями=паааареностями
парень стоит и смотрит=парень стоиит и смотрит
париков=парикооов
парила над соперниками=париъла над соперниками
Пароль 2486 =Пароль две тысячи 486 
пару минут=пару минуут
пас подвернувшимся на поле=пас подвернувшимся на поъле
Пасадену=Пасадээну
Паскуале=Паскуаале
патетична=патэтиична
патлатая=патлатаая
патологично=патологииично
патологичной=патологииичной
патриархатов=патриархааатов
патриотически-оптимистической=патриотиически-оптимистической
патрицианского=патрициаанского
патрулем=патрулём
паях=паяах
пейотль=пейоотль
пелось=пеълось
пеньки зубов=пеньки зубоов
пепси-колу=пепси-коълу
Пепсодент=Пэпсодэээнт
перевезены в другое место =перевезеныыыыы в другое место 
перевела глаза=перевела глазаа
Перед началом самообучения=Перед началом самообучеээния
передал ему слова=передал ему словаа
передвигать=передвигаааать
передвинулись к центру поля=передвинулись к центру поъля
переделывать все по своему вкусу=переделывать всё по своему вкусу
передозировки=передозироооовки
пережала =пережаала 
перезарядки=перезаряаадки
перейти черту=перейти чертуу
перекипело все=перекипело всё
переменного цвета стены=переменного цвета стеъны
перемигиванием=перемиигиванием
переминавшая=переминаавшая
перенесся=перенёсся
переносного=переноснооого
переносной=переносноооой
перепечатать статью=перепечатать статьюу
переправкой=перепраавкой
пересекающие дно реки=пересекающие дно рекии
пересекла черту=пересекла чертуу
переставляла ноги=переставляла ноъги
пересъемка=пересъёмка
Пересядько=Пересяадько
перетаскивают на берег=перетаскивают на беърег
персонифицировало=персонифициировало
перцепиент=перцепиеэнт
перцепиентов=перцепиеэнтов
перцептрон=перцептрооон
перцептрона=перцептроона
перьевой=перьевооой
Петенька=Пеэтенька
Петина=Пеэтина
Петиного=Пеээтиного
Петиной=Пеэтиной
Петиному=Пеээтиному
Петины=Пеэтины
Петиным=Пеэтиным
петли заботливо смазаны=пеътли заботливо смазаны
Петя-1=Петя 1
пикник=пикниик
пикселов=пиикселов
пила её тело=пилаа её тело
Пилат=Пилаат
пили газировку=пиъли газировку
Пиночет=Пиночеээт
Пиночета=Пиночеэта
пионерски=пионеэрски
пистолетик=пистолеэтик
пистолетик-то=пистолеэтик-то
Пистолетник=Пистолеэтник
пищи было в избытке=пиъщи было в избытке
плазмеметом=плазмомётом
плазмеметы=плазмомёты
плазмозащитные=плазмозащиитные
плазмозащитный=плазмозащииитный
Плазмомет=Плазмомёт
плазмомет=Плазмомёт
плазмомета=плазмомёта
плазмометами=плазмомётами
плазмометик=плазмомётик
плазмометный =плазмомётный 
плазмометов=плазмомётов
плазмометом=плазмомётом
плазмомету=плазмомёту
Платон =Платоон 
плацкартноликих=плацкартнолиииких
плачу за работу=плачуу за работу
плащевки=плащёвки
пленительницы =плениительницы 
пленочки=плёночки
плечом к плечу=плечоом к плечуу
плодом воспаленного воображения=плодоом воспаленного воображения
плодом их теорий=плодоом их теорий
плодом моего=плодоом моего
плоды и зверье =плоды и зверьё 
площадка за городом=площадка за гооородом
плюсовая=плюсоваая
плюханьем=плюуханьем
по всему телу волны=по всему телу воълны
по державе нашей=по державе наъшей
по обе стороны =по обе стоороны 
по обычным проводам=по обычным проводааам
по разные стороны=по разные стоороны
по сидящему за рулем=по сидящему за рулём
по столам - кто виски=по столам - кто виъски
по уклонистому участку=по уклоонистому участку
по-анданорски=по-анданоорски
По-арамейски=По-арамеэйски
по-арамейски=По-арамеэйски
по-гангстерски=по-гаангстерски
по-гречески=по-греэчески
по-деревенски=по-деревеээнски
по-европейски=по-европеэйски
по-командирски=по-командиирски
по-людски=по-людскии
по-мердоковски=по-меээрдоковски
по-мужски=по-мужскии
по-своему=по-свооему
по-старчески=по-стаарчески
по-холостяцки=по-холостяацки
по-христиански=по-христиаански
по-шпагински=по-шпаагински
побалдеть=побалдеээть
победа самой смерти=победа самоой смерти
поблагодарил Господа=поблагодарил Гоооспода
поболит=поболииит
поболтать на ходу=поболтать на ходуу
повежливее=повеэжливее
Повелитель знаком велел гвардейцам удалиться=Повелитель знаъком велел гвардейцам удалиться
повернул ее за плечи=повернул ее за плеъчи
повернуть головы=повернуть гооьловы
поверх толстых шерстяных носков=повеээрх толстых шерстяных носков
повествовательно=повествоваательно
поводком=поводкооом
повскакивали=повскаакивали
повстанцы все стреляли=повстанцы всё стреляли
повторяю я слова=повторяю я словаа
повыдергивать=повыдёргивать
повылезали=повылезааали
повытирал=повытираааал
погильотинному=погильотииинному
поглубжз=поглубжэ
поглядывая на небо=поглядывая на неъбо
погонялой=погоняалой
погребен=погребён
погрубее=погрубеэе
под Лениным окном=под Леэниным окном
под опухшими веками =под опухшими веэками 
под стальные объятия петли=под стальные объятия петлии
под эгидой ООН=под эгидой О-ОооН
подают жаркое=подают жаркоъе
подбирая слова=подбирая словаа
подвигающего=подвигаающего
подвигаясь=подвигааясь
подголовник=подголоовник
подготовлен в вылету=подготовлен к вылету
поддакиванья=поддаакиванья
поддерживающим все это=поддерживающим всё это
поджав губы=поджав гуъбы
поджав ноги=поджав ноъги
поджаристые=поджааристые
подзарядить=подзарядиииить
подзарядки=подзаряадки
Подзаряжается=Подзаряжаается
подкондылять=подкондыляааать
поднимет глаза=поднимет глазаа
поднимите руки=поднимите руъки
поднимусь=поднимууусь
поднывал=поднывааал
поднырнул=поднырнууул
подняв глаза=подняв глазаа
поднял глаза=поднял глазаа
подняла глаза=подняла глазаа
подняла обе ноги=подняла обе ноъги
подняла руки=подняла руъки
поднятой ею пыли=поднятой ею пыъли
подошел к покеристам=подошел к покериистам
подпространстве=подпростраанстве
подростковой=подросткоовой
подступы к мосту =подступы к мостуу 
подтвердит слова свидетеля=подтвердит словаа свидетеля
подтверждает слова=подтверждает словаа
подтверждаю слова свидетеля=подтверждаю словаа свидетеля
подтверждающие промышленную отсталость Города=подтверждающие промышленную отсталость Гоорода
подтеками =подтёками 
подтруниваниями=подтрууууниваниями
подтянула ноги=подтянула ноъги
подхватив её стопы=подхватив её стоъпы
подхватили е„=подхватили её
Подчитал=Подсчитал
подымались на берег=подымались на беърег
поедем верхом=поедем верхоом
Поедем-ка=Поедем-каа
пожали друг другу руки =пожали друг другу руъки 
пожимает нам руки=пожимает нам руъки
пожимая нам руки=пожимая нам руъки
позаботимся обо всем=позаботимся обо всём
позаботишься обо всем=позаботишься обо всём
Позади меня стоит=Позади меня стоиит
позднее старостой цеха=позднеэе старостой цеха
поздоровался с самой собственно=поздоровался с самоой собственно
поземному=поземноому
позицию в лесу=позицию в лесуу
познанного=пооознанного
познанному=пооознанному
познано=поознано
позументной=позумеэнтной
позывному=позывноому
поинтимней=поинтиимней
поискрить=поискрииить
поймет=поймёт
пока не получите=пока не полуучите
покинувшей краны во всем доме=покинувшей краныы во всём доме
покопалась=покопаалась
покопались=покопаались
покопаюсь=покопааюсь
покруглее=покруглеэе
покрытое обильным потом=покрытое обильным поътом
Покупает голоса=Покупает голосааа
покупать голоса=покупать голосааа
пол-акра зубов=пол-акра зубоов
полбокала=полбокаала
полбокала виски=полбокаала виъски
полбригады=полбригаады
полвагона=полвагоона
полголовы=полголовыыыы
полет нормальный=полёт нормальный
полетели в стороны=полетели в стоороны
поливала все вокруг=поливала всё вокруг
полилось в фужер=полилооось в фужер
политесы=политеэсы
политехнички=политехнииички
политехничку=политехнииичку
полковничьего сознания =полкоовничьего сознания 
полковничьему=полкоовничьему
полмагазина=полмагазииина
полно и исчерпывающе=поълно и исчерпывающе
полно соплей=полно соплеъэй
полногубый=полногуубый
полным-полно=полныым-полно
половину проводов скрутил=половину проводооов скрутил
полого уходила=полоъгго уходила
полосы отчуждения=полосыыы отчуждения
полстакана=полстакаана
полтора часа=полтора часаа
полуамериканской=полуамерикааанской
полуарка=полуаарка
полубоком=полубооком
полуевропейской=полуевропеэээйской
полузакрыв глаза=полузакрыв глазаа
полузасыпав=полузасыыыпав
полукриминальный=полукриминаааальный
полукустарного=полукустаарного
полулегендарной=полулегендаааарной
полуобморочное=полуообморочное
полуобняв=полуобняааав
полуобнял=полуобняааал
полуоткровенности=полуоткровеээнности
полуоторванный=полуотоорванный
полуприкрытые=полуприкрыытые
полупроницаемый=полупроницаааемый
полупроницаемым =полупроницаааемым 
полупроницаемыми=полупроницааемыми
полусекретный =полусекреээтный 
полусидя=полусиидя
полусожженного=полусожжённого
полусухим=полусухиииим
полуфабрикатных=полуфабрикаааатных
получила сведения=получила свеээдения
полы его длинного=полыы его длинного
полыхнул=полыхнууул
помародерствовать=помародёрствовать
помета еще больше=помёта еще больше
помнил все о Рослове=помнил всё о Роослове
помните - если хотите вернуться=пооомните - если хотите вернуться
Помните песню=Поомните песню
Помните предупреждение =Поомните предупреждение 
Помните то время=Поомните то время
помолоть=помолоооть
помою руки=помою руъки
помянет=помяънет
помянутый=помяанутый
пони-нут=покинут
понимал все это=понимал всё это
Понтия=Поонтия
пооборвала=пооборвааала
пооборвала бы я им руки=пооборвааала бы я им руъки
попадали друг на друга=попаадали друг на друга
поперек груди=поперек грудии
поперчит=поперчииит
попила=попилааа
поплескал=поплескааал
попостился=попостиился
пора просыпаться=пора просыпааться
пораженностью=поражённостью
поразмять=поразмяаать
поразмять бы ноги=поразмяаать бы ноъги
порежение=поражение
пореспектабельней=пореспектаабельней
порулил=порулииил
Порученец=Поручеэнец
порученцы=поручеэнцы
порционно =порциоонно 
порцию жаркого=порцию жаркоъго
посезонно=посезоонно
посерьезнела=посерьёзнела
поскрипывание=поскрииипывание
после казни=после каъзни
После колледжа=После коолледжа
последние слова голоса=последние слова гоолоса
послеобысковую=после обысковую
посложней=посложнеээй
посмотрел на руки=посмотрел на руъки
Посмотреть бы кругом=Посмотреть бы кругоом
поста дежурной=постаа дежурной
поставить ноги=поставить ноъги
постанывающего=постаааанывающего
посудомоечной =посудомооечной 
посушила=посушиила
потерла губы=потёрла гуъбы
потерявшим голоса =потерявшим голосааа 
потеряется из виду=потеряется из виъду
потерянности=потеэрянности
потирая руки=потирая рууки
потовых желез=поотовых желез
потому что дела не так=потому что делаа не так
потрезвее=потрезвеэе
потрепанного=потрёпанного
потупив глазки=потупив глаъзки
потупила глаза=потупиила глазаа
потянуло характерной=потянуло характеэрной
похолодело в груди=похолодело в грудии
похохмил=похохмииил
поцелуй была томным=поцелуй был томным
почему все достается=почему всё достается
Почему стоим=Почему стоиим
почти не видное глазу=почти не виидное глазу
появились на виду =появились на видуу 
Пр-р-роклятье-е-е=Прррокляаатье-е-е
прeподают=преподают
правдоматколюбцы=правдоматколюуубцы
правильные черты лица=правильные черты лицаа
правящих классов определяет цели войны=правящих классов определяет цели войныы
превосходить солдат во всем=превосходить солдат во всём
предательница=предаательница
предательнице=предаательнице
предательницу =предаательницу 
предательницы =предаательницы 
предбоевой=предбоевоооой
предложение все еще в силе=предложение всё еще в силе
предоккупационные=предоккупациоооонные
предсумеречное=предсумереэчное
предупреждающе=предупреждаающе
президентша=президеэнтша
президентши=президеэнтши
президентшу=президеэнтшу
презрительно-недоуменным=презрительно-недоумённым
преизрядно=преизряадно
прекратить все это=прекратить всё это
пренебрегшей=пренебрёгшей
преотлично=преотлиично
преребивая=перебивая
пресмешно=пресмешнооо
претора=претоъра
преторианской=преториааанской
при всем желании=при всём желании
при всем своем уважении=при всём своем уважении
при всем старании=при всём старании
При всем том=При всём том
при самом лучшем лечении=при саъмом лучшем лечении
приближенный вариант=приближённый вариант
прибором ночного видения=прибором ночного вииидения
приготовлением пищи=приготовлением пиъщи
придана нашей бригаде=придаана наъшей бригаде
придумал все это=придумал всё это
приемопередатчик=приёмо-передатчик
приемчику=приёмчику
прижав её руки=прижав её руъки
прижав руки=прижав руъки
прижавшими руки=прижавшими руъки
прижала к груди руки=прижала к груди руъки
приземлила=приземлиила
приземлит=приземлииит
призрачно=приизрачно
призывная повестка=призывнаая повестка
прийти на поле=прийти на поъле
приказом нашей командирши=приказом наъшей командиирши
прикрыв глаза=прикрыв глазаа
прикрыла глаза=прикрыла глазаа
прикрыла глаза веками=прикрыла глазаа веэками
прикупом=приикупом
применены=примененыыы
примете в том прямое участие=приимете в том прямое участие
приметившейся=примеэтившейся
примостить=примостииить
принадлежания=принадлежаания
приносил жара не меньше=приносил жаъра не меньше
Принстонского=Прииинстонского
Принстону=Приинстону
принял к сведению=принял к свеээдению
приобняла=приобняала
приоткрыть глаза=приоткрыть глазаа
приперченное =приперчённое 
приречных=приречныыых
присочинять=присочиняааать
приставалу=приставаалу
присутствие на отрубании головы=присутствие на отрубании головыыы
присушиваясь=прислушиваясь
притонодержателей=притонодержааателей
причитанья=причитаанья
прищуря глаза=прищуря глазаа
приятный запах=приятный заъпах
пробегал или проезжал=пробегааал или проезжал
пробегал мимо=пробегааал мимо
пробегал мимо аптеки=пробегааал мимо аптеки
пробегал с окровавленной=пробегааал с окровавленной
пробегала рядом=пробегаала рядом
пробегали слова=пробегаали словаа
Проболтается мальчишка - узнает=Проболтается мальчишка - узнаъет
пробуксовал=пробуксоваааал
проверил номера=проверил номерааа
провода под смертельно высоким=проводааа под смертельно высоким
проводами и светофорами=проводаами и светофорами
проводивших захват Земли=проводивших захват Землии
Проводов было много=Проводооов было много
прогневило=прогнеэвило
продали все целиком =продали всё целиком 
продвигается на север=продвигаается на север
продвинутостью=продвиинутостью
продержаться до 13=продержаться до тринадцати
Проект-1=Проект 1
Проиграл - плачу=Проиграл - плачуу
проклинали все и всех=проклинали всё и всех
прокормить семью=прокормить семьюу
прокурорши=прокуроорши
пролетали пуховые пары=пролетали пуховые паъры
ПРОЛОГ=ПРОЛОоГ
промедлений=промедлеэний
Проморгавшись=Проморгаавшись
промял=промяал
пронзив тела разрядом=пронзив телаа разрядом
пронизал все тело=прониъзал все тело
проникла в их тела =проникла в их телаа 
проникнут на полосы=проникнут на поолосы
Пропавшее оружие=Пропаавшее оружие
пропарывает=пропаарывает
пропитавшего все вокруг=пропитавшего всё вокруг
пропитала все свитера=пропитала все свитэрааа
пропитанный джин-тоником =пропитанный джин-тооником 
проседал=проседааал
просекли=просеклиии
просканируй=просканиируй
проскрежетала=проскрежетааала
Проснувшиеся=Проснуувшиеся
просто шмякнется=просто шмяакнется
просто-напросто=просто-наапросто
пространственно-временных=пространственно-временныыых
прострочили=прострочиили
простые жители Земли=простые жители Землии
просцениума=просцеэниума
просыпался в диком страхе=просыпаался в диком страхе
просыпался Володя без досады =просыпаался Володя без досады 
просыпался и шел на работу=просыпаался и шел на работу
просыпался рано утром=просыпаался рано утром
просыпаться дождливым утром =просыпааться дождливым утром 
Просыпаться мне ужасно не хотелось=Просыпааться мне ужасно не хотелось
протагонистов=протагонииистов
протекающие где-то далеко=протекающие где-то далекооо
противо-воздушная=проотиво-воздушная
противосенсорной=противосэээнсорной
противосенсорную=противосээнсорную
протягивая к ней руки=протягивая к ней руъки
протянул руки=протянул руъки
протянула руки=протянула руъки
профессионализма=профессионалииизма
профыркается=профыыркается
прохрапишь=прохрапииишь
прочесть было уже невозможно=прочеъэсть было уже невозможно
Прочие же части тела=Прочие же части теъла
прочили мне карьеру звезды=прочили мне карьеру звездыы
Прочитав статью =Прочитав статьюу 
прочтены заклятия=прочтеныыы заклятия
прочь из замка=прочь из заъмка
прошедшей боли в глубине руки=прошедшей боъли в глубине рукии
прошеного=проооошеного
прошила его насквозь=прошила его насквоозь
прутом=прутоом
прыгательные задние ноги=прыыыгательные задние ноги
прыгательными=прыыыыгательными
прядку волос=прядку волоос
прядь волос=прядь волоос
прятал глаза=прятал глазаа
псевдо-Рослова=псевдо-Роослова
псевдожизнь=псевдожииизнь
Псевдожизнью=Псевдожиизнью
псевдозаработками=псевдозааработками
псевдоисторические=псевдоисториические
псевдометаллист=псевдометаллииист
псевдомощью=псевдомоощью
псевдонеобходимостью=псевдонеобходиииимостью
псевдоромантикой=псевдоромаантикой
псевдосупермена=псевдосупермээээна
псевдоязыке=псевдоязыкеээээ
психовоздействия=психовоздеэйствия
птиц на проводах=птиц на проводааах
Пуар=Пуаар
пузыречек=пузырёчек
пулемет все стучал=пулемет всё стучал
пунцовея=пунцовеэя
пурген=пургеэн
пустоты или там еще что=пустоъты или там еще что
пустынях =пустыънях 
путана неоднократно докрашивала=путаъна неоднократно докраашивала
пучки проводов =пучки проводооов 
Пушкину=Пуушкину
пущать=пущаать
пшикнула=пшиикнула
Пыли здесь немного=Пыъли здесь немного
пыточной=пыыточной
Пышечка=Пыышечка
Пэррота=Пээррота
Пэрротом=Пээрротом
Пэрроту=Пээрроту
пялившего глаза=пялившего глазаа
пялилась на стоящие=пялилась на стояащие
пятидесяти метрах=пятиидесяти метрах
пятидесятимиллиметровые=пятидесятимиллиметрооовые
пятизначным=пятизнаачным
пятисоткилограммовую=пятисот-килограммовую
пятиствольный=пятиствоольный
равная 972 человекам=равная девятисот семидесяти двум человеэкам
равно как и ущерб=раъвно как и ущерб
ради блага=ради блаъга
радиомаячком=радио-маячком
РАДИОРЫНОК=радиорынок
Радонежский=Рааадонежский
разбегавшихся в стороны людей=разбегаавшихся в стоороны людей
разбегались теперь по своим щелям=разбегаались теперь по своим щелям
разбегающихся =разбегаающихся 
разбить себе головы=разбить себе гооооловы
разведшколе=разведшкооле
развернув бедра=развернув бёдра
развлекушки=развлекуушки
развяжу тебе руки=развяжу тебе руъки
развязывала ноги =развязывала ноъги 
развязывать ноги=развязывать ноъги
разговаривая обо всем=разговаривая обо всём
разгораясь все ярче=разгораясь всё ярче
разграблять=разграбляаать
раздёленную=разделённую
раздалась в стороны=раздалась в стоороны
раздвигая в стороны=раздвигая в стоороны
раздвинула ноги=раздвинула ноъги
раздвинула пошире ноги=раздвинула пошире ноъги
Раздвинь ноги=Раздвинь ноъги
раззявленные=раззяавленные
разлепив=разлепииив
размешен=размещен
размять ноги=размять ноъги
разновеликими окнами=разновелиикими окнами
разнообразной пищи=разнообразной пиъщи
разные части тела=разные части теъла
разобрав на органы=разобрав на оорганы
разошлись в стороны=разошлись в стоороны
разразилась сейчас в душе Владимира=разразилась сейчас в душеэ Владимира
разреженнее=разрежённее
разреженной дыхательной смеси=разрежённой дыхательной смеси
разреше-ния =разрешения 
разъем=разъём
Разъехавшиеся в стороны=Разъехавшиеся в стоороны
разъехались в стороны=разъехались в стоороны
раковинки=раааковинки
рамочка=раамочка
рамочке=раамочке
Рано или поздно мы узнаем=Рано или поздно мы узнаъем
ранчмен=ранчмеэн
расказывала=раскаазывала
Раскаленно-розовый=Раскалённо-розовый
раскинув руки=раскинув руъки
раскинуты в стороны=раскинуты в стоороны
Раскрыв глаза=Раскрыв глазаа
раскрыв глаза=Раскрыв глазаа
раскрыла глаза=раскрыла глазаа
раскупориванию=раскупооориванию
распахнула глаза=распахнула глазаа
распрекрасном=распрекраасном
Рассердился Бог=Рассердился Бох
расскажем все Стилу=расскажем всё Стилу
рассказать все жене=рассказать всё жене
рассмеявшись=рассмеяавшись
рассмотреть их лица=рассмотреть их лиъца
расставит все по своим местам=расставит всё по своим местам
расставить руки=расставить руъки
расстрелять чудовище изавтомата=расстрелять чудовище из автомата
расталкивая нас в стороны=расталкивая нас в стоороны
растопило-таки снега=растопило-таки снегаа
раструбы=рааструбы
расценить слова=расценить словаа
расчесанные=расчёсанные
расчетливого маньяка=расчетливого маньякааа
расшвыривало в стороны=расшвыривало в стоороны
расшитыми золотом спинами=расшитыми зоолотом спинами
расшитых золоюм ллвреях=расшитых зоолотом ливреях
рвал зубами =рвал зубаъми 
рванет на груди=рванет на грудии
рванье=рваньё
реальные стороны=реальные стоороны
ревущего кругом океана =ревущего кругоом океана 
резаная=реээзаная
резкостями=реээзкостями
рекламу казни=рекламу каъзни
Рекс=Рэкс
Рекса=Рэкса
Рексов=Рэксов
Рексу=Рэксу
Рексы=Рэксы
Ренье=Реньеэ
рецепторами =рецеэпторами 
ригодности=пригодности
римейк=римеэйк
Ринат=Ринаат
Ринитом=Ринатом
Риос=Риоос
Робинзоны=Робинзооны
робокостюм=робокостюууум
робокостюма=робокостюуума
робокостюмами=робокостюумами
робокостюмах=робокостюуумах
робокостюме=робокостюууме
робокостюмов=робокостюуумов
робокостюмом=робокостюуумом
робокостюму=робокостюууму
робокостюмы=робокостюуумы
Роботюшка =Роооботюшка 
рожки да ножки=роъжки да ножки
Розенбаума=Розэнбаума
розово-желтым=роозово-желтым
Рокленде =Роокленде 
Роклендской=Рооклендской
Ромео=Ромэо
Роммеля =Рооммеля 
Рондельцы=Роондельцы
Рослова=Роослова
Рослова-игрока=Роослова-игрока
Рослове=Роослове
рословской=рооословской
Рослову=Роослову
Рословым=Роословым
Рословым-футболистом=Роословым-футболистом
Рословым-юношей=Роословым-юношей
ротики=роотики
рубенсовские=руууубенсовские
руки в него=руъки в него
Руки Владимира=Руъки Владимира
Руки девушки=Руъки девушки
руки его отвратительно=руъки его отвратительно
руки за спиной=руъки за спиной
руки и губы=руъки и гуъбы
руки и ноги=руъки и ноъги
руки или ноги=руъки или ноъги
руки кадрового военного=руъки кадрового военного
Руки можете опустить=Руъки можете опустить
руки на поручнях=руъки на поручнях
руки помой=руъки помой
Руки с зажатыми=Руъки с зажатыми
руки судорожно сжались=руъки судорожно сжались
руки судьи=руъки судьии
руки тоже пристойно=руъки тоже пристойно
руки-то - в стену вмурованы=руъки-то - в стену вмурованы
Рукоприкладства=Рукоприклаааадства
рукотворный=рукотвоорный
русоволосый=русоволооосый
Рутефорд=Рутэфооорд
рыболовство=рыболоовство
ряби=ряъби
с 01 по 03=с ноль один по ноль три
с 1 марта=с первого марта
с 1 января=с первого января
с 1550 по=с тысяча пятисот пятидесятого по
с больными=с больныыми
с детекторами запаха=с детекторами заапаха
с дощечками на груди=с дощечками на грудии
с ДСА10 - в руки=с ДСА10 - в руъки
с её головы берет=с её головы береэт
с е„ лица=с её лица
с Земли давным-давно=с Земли давныым-давно
с каких пор начал думать=с каких пор наъчал думать
с картонными коробками=с картонными короъбками
с которого начал=с которого наъчал
С кружками в руках=С круужками в руках
с Мечтой=с Меччтоой
с молоком матери=с молоком маатери
с напряжением в сети=с напряжением в сетии
с нашей жизнью=с наъшей жизнью
с нашей помощью=с наъшей помощью
С нашей стороны=С наъшей стороны
с нашей стороны=С наъшей стороны
с нейтронным приводом=с нейтронным прииводом
с ног не валит=с ног не ваълит
с первой полосы =с первой полосыыы 
с пивными кружками=с пивными круужками
с плевком в душе=с плевком в душеэ
с полопавшимися сосудами=с полооопавшимися сосудами
с приготовлением пищи=с приготовлением пиъщи
с расстояния 30-40 метров =с расстояния тридцати-сорока метров 
С сегодняшнего утра остров=С сегодняшнего утраа остров
с Сорок второй=с Соърок второй
с точки зрения самого=с точки зрения самовооо
с тошнотворным запахом=с тошнотворным заапахом
с утра здесь стоит=с утра здесь стоиит
с хорошей московской=с хороъшей московской
с шипением схлопнулись=с шипением схлоопнулись
с юга к складам=с юга к складаам
Садимся на привинченные=Садиъмся на привинченные
садится в машину=садиътся в машину
Сайруса=Саайруса
Сайрусу=Саайрусу
сами же дышите=сами же дыышите
самовопрос=самовопроооос
Самогипноз=Самогипнооооз
самого беспокоит=самовооо беспокоит
самого полковника=самовооо полковника
Самого робота=Самовооо робота
самого спросите=самовооо спросите
самое лучшее=саамое лучшее
самое начало=саамое начало
самое страшное=саамое страшное
самоиронии=самоироонии
самоисключение=самоисключеээние
самой безумной мечты=саъмой безумной мечты
самой казалось=самоой казалось
самой Лее=самоой Лее
самой не впасть=самоой не впасть
самой рассказать=самоой рассказать
самой-взрослой-девочки-из-всех=саъмой-взрослой-девочки-из-всех
самолетиком =самолётиком 
самом мощном=саъмом мощном
самомодифицирующихся=самомодифициирующихся
самому старшему=саамому старшему
самоорганизующаяся=самоорганизуующаяся
самоорганизующейся=самоорганизууующейся
самоответа=самоотвеээта
самописцев=самопиисцев
самопрограммируюшееся=самопрограммирующееся
Самочка=Саамочка
самочка=Саамочка
самочку=саамочку
Сан-Фердинандо=Сан-Фердинаандо
Сан-Хосе=Сан-Хосээ
сандвич=сэндвич
Санек=Санёк
сапиенс=саапиенс
Саранчей=Саранчёй
сахарно-белого=саахарно-белого
сбросив все железное=сбросив всё железное
сбросила туфли=сбросила туъфли
свадебно=сваадебно
сведений о нем=свеэдений о нем
свежее-перекопанному=свеже-перекопанному
свежей крови=свеъжей крови
свежей паутиной полку=свежей паутиной поълку
свежеотлитым=свежеотлииитым
свежепокрашенной=свежепокраашенной
сверхинтеллектом=сверхинтеллеээктом
сверхновых=сверхноовых
сверхоригинальными=сверхоригинааальными
сверхпотрясающей =сверхпотрясаающей 
сверхэнергия=сверхэнэргия
свет прожекторов=свет прожектороооов
светло-коричневой=свеътло-коричневой
светло-кофейного=свеътло-кофейного
светло-пшеничными=свеътло-пшеничными
светло-сером=свеътло-сером
светло-соломенного=свеътло-соломенного
светло-соломенные=свеътло-соломенные
свеча все пульсировала=свеча всё пульсировала
Свечи в канделябрах=Свеъчи в канделябрах
свечи в канделябрах=Свеъчи в канделябрах
свинцовым дождем=свинцовым дождём
свинячьими глазками=свинячьими глаазками
своди все мышцы=сводит все мышцы
свои души=свои дуъши
своих людей для осмотра дома=своих людей для осмотра доъма
сволочное=сволочноое
свяжи себе ноги=свяжи себе ноъги
связал себе ноги=связал себе ноъги
связываем руки=связываем руъки
связывай себе ноги=связывай себе ноъги
связывал себе ноги=связывал себе ноъги
сглатывая=сглааатывая
сгребя=сгребяа
сделал все чертовски быстро=сделал всё чертовски быстро
сделать ноги=сделать ноъги
сдернула её руки=сдернула её руъки
северном и южном полюсах=северном и южном полюсааах
северо-востоке=сеэверо-востоке
северо-востоку=сеэверо-востоку
северо-восточных=сеэверо-восточных
северо-запад=сеэверо-запад
северо-запада=сеэверо-запада
северо-западнее=сеэверо-западнее
северо-западней=сеэверо-западней
сегодня еще узнаем что-то=сегодня еще узнаъем что-то
Сейчас вы спросите=Сейчас вы спроосите
Сейчас запах королевы=Сейчас заъпах королевы
Селеста-7000=Селеста 7000
Селестан=Селестааан
Селестин=Селестииин
сели в одну машину=сеъли в одну машину
сельхозвредителей=сельхозвредиителей
Семиметровый=Семиметрооовый
Семка=Сёмка
Семке=Сёмке
Семкой=Сёмкой
Семчик=Сёмчик
семь утра=семь утраа
сенаторскую=сенааторскую
сенсор=сэнсор
сенсорами=сэээнсорами
сенсоров=сээнсоров
Сенсоры=Сээнсоры
Сентябрь 2021 года=Сентябрь две тысячи двадцать первого года
серебристые капли воды=серебристые капли водыы
середнячки=середнячкииии
серпантин дороги=серпантин дороъги
серфингом=сеэрфингом
серьёным=серьёзным
Сесиль=Сесииль
сестринских=сестриинских
сети Интернет=сетии Интэрнэээт
сеть дорог=сеть дороог
Сечь-то=Сеччь-то
сжав губы=сжав гуъбы
сжавшуюся=сжааавшуюся
сжал губы=сжал гуъбы
сжала губы=сжала гуъбы
сжала зубами=сжала зубаъми
сжевать=сжеваать
сжимала зубами=сжимала зубаъми
сжимая ноги=сжимая ноъги
сигануть=сигануууть
сигарных коробках=сигарных короъбках
сидели и пили=сидели и пиъли
сидеть на полу все так=сидеть на полу всё так
сидят дома=сидят доъма
Силлур=Силлуур
СИЛЛУР=Силлуур
силлуриан=силлуриааан
силлурианам=силлуриааанам
силлурианами=силлуриаанами
силлуриане=силлуриааане
силлурианин=силлуриааанин
силлурианка=силлуриааанка
силлурианке=силлуриааанке
силлурианки=силлуриааанки
силлурианкой=силлуриааанкой
силлурианку   =силлуриааанку
силлурианская=силлуриаанская
силлурианские=силлуриаанские
Силлурианский=Силлуриааанский
силлурианским=силлуриааанским
силлурианскими=силлуриааанскими
силлурианских=силлуриааанских
силлурианского=силлуриаанского
силлурианскогошоссе=силлурианского шоссе
силлурианской=силлуриааанской
силлурианца=силлуриааанца
силлурианцы=силлуриааанцы
силлурийцы=силлурииийцы
силовых кабелей=силовых кабелеээй
Силур=Силуур
СИЛЬВЕРВИЛЛЬ =Сильвервилль
сильной степени выраженности=сильной степени выыыыраженности
Симпсона=Сиимпсона
Синай=Синаай
СИСТЕМЗ=Системз
системы хорошо защищены=системы хорошо защищеныыыы
сказал далеко=сказал далекооо
сказовных=сказочных
скакал верхом=скакал верхоом
скаламбурить=скаламбуурить
скат острова надвинулись другие=скат оострова надвинулись другие
Скви-и-р-р-р =Скви-иррр 
Сквир-р-р=Сквиррр
сквирлами=сквиирлами
сквирловских=сквиирловских
сквознячок=сквознячооок
сквозь толщу воды=сквозь тоълщу водыы
склеенность=склеэенность
склонен к самоубийству=склоънен к самоубийству
сковороду=сковородуууу
сколь-нибудь=сколь-нибуудь
сколько-нибудь=сколько-нибуудь
Скосив глаза=Скосив глазаа
скосил глаза=скосил глазаа
скосила глаза=скосила глазаа
скрежетнувший=скрежетнуувший
скрестив ноги =скрестив ноъги 
скрим-лиха=скриимлиха
скримлика=скриимлика
скримликам=скриимликам
Скримлики=Скриимлики
скримлики=Скриимлики
скримликов=скриимликов
Скримлиха=Скриимлиха
скримлихи=скриимлихи
скримлиху=скриимлиху
Скрип зубов=Скрип зубоов
скрути-ка ему руки=скрути-ка ему руъки
скручивал провода=скручивал проводааа
скручивал теперь провода=скручивал теперь проводааа
скручивать провода=скручивать проводааа
скручивать себе ноги=скручивать себе ноъги
скупать голоса=скупать голосааа
Скусными=Искусными
слабительной соли =слабительной соъли 
слабый запах=слабый заъпах
слаженными парами=слаженными паарами
слаломист=слаломииист
следущем=следующем
слез глаза королевы=слёз глаза королевы
слезным=слёзным
слезу пустить может=слезуу пустить может
слипшиеся глаза=слипшиеся глазааа
Слишком далеко =Слишком далекооо 
слишком далеко от них=слишком далекооо от них
Слова Боссы=Словаа Боссы
слова были произнесены =слова были произнесеныыыыы 
слова застряли в глотках=слова застряли в глоътках
слова молитвы =словаа молитвы 
слова сносит=словаа сносит
словно бы погруженным=словно бы погружённым
сложив губы=сложив гуъбы
сложив руки=сложив руъки
сложнопередаваемой=сложно-передаваемой
слои шерсти=слои шеърсти
слуги мои=слуъги мои
слуховые сенсоры=слуховые сээнсоры
слушаем сейчас только голоса=слушаем сейчас только голосааа
смаргивая=смаааргивая
смел задним числом=смеъл задним числом
сметет и самого=сметет и самовооо
СМИ-И-ИРНА-А-А-А-А =Смииирнаааааа
смоляне-черными=смооляне-черными
смотреть на все это=смотреть на всё это
Смотрите на карты=Смотриъте на карты
Снайдерса =Снаайдерса 
снеголет=снеголёт
снеголетами=снеголётами
снеголете=снеголёте
снеголетом=снеголётом
снеголеты=снеголёты
снежной бури=снежной буъри
снизилась до 37 и 2=снизилась до тридцати семи и двух
снять шлем=снять шлеъм
со 105-мм орудием=со сто-пяти-миллиетроооовым орудием
со всеми потрохами=со всеми потрохаами
со всех сторон испокон века=со всех сторон испокон веъка
со многими свитерами=со многими свитэраами
соберет все сведения=соберет все свеээдения
собираешься все стереть=собираешься всё стереть
соблазнительный запах=соблазнительный заъпах
собор на горе =собор на гореэ 
собрал все сведения=собрал все свеээдения
собрала взглядом голоса=собрала взглядом голосааа
собраны истории=сообраны истории
Событийная=Собыыытийная
события минувшей ночи=события минуъвшей ночи
совершенный облик=совершеъэнный облик
согнувшиеся=согнуувшиеся
согреть ноги=согреть ноъги
содержанту=содержаанту
соду-виски=соду-виъски
соды-виски=соды-виъски
создавая поля=создавая поляа
созерцать их тела=созерцать их телаа
Сокрушитель=Сокрушиитель
Соловьева=Соловьёва
Соловьевой=Соловьёвой
Соловьеву=Соловьёву
сомкнула глаза=сомкнула глазаа
сопли не вытерла=соъпли не вытерла
соседней очереди стоит=соседней очереди стоиит
состредоточенно=сосредоточенно
сотней квадратных метров воды=сотней квадратных метров водыы
соударяясь=соударяааясь
сохранят все в тайне=сохранят всё в тайне
сохранять во всем=сохранять во всём
социал-демократии=социааал-демократии
социальноопасный=социальноопааасный
соцсоревнований=соцсоревновааааний
спала не так глубоко=спала не так глубокооо
спали-таки=спаъли-таки
спасительница=спасиительница
спасительницей=спасиительницей
спасительницы=спасиительницы
спать не так глубоко=спать не так глубокооо
спать сидя=спать сиъдя
спекшиеся=спёкшиеся
спекшуюся=спёкшуюся
Спецназначением=Спецназначеэнием
спецназначением=Спецназначеэнием
спецсостав=спецсостааав
спихнуть клиенту жилье=спихнуть клиенту жильё
сплести ноги=сплести ноъги
сползавшего по стеклу=сползаавшего по стеклу
сползала с лица=сползаала с лица
Спортпаласе=Спортпалаасе
Спорщицы=Споорщицы
способствовали вентиляции головы=способствовали вентиляции головыыы
Справа горы=Справа гоъры
Спрингстина=Сприингстина
Спроси его самого=Спроси его самовооо
Спросите его самого=Спросите его самовооо
спрута с разноцветными проводами щупалец=спруъта с разноцветными проводаами щупалец
спрятала руки=спрятала руъки
спрятали в лесу =спрятали в лесуу 
спрятать глаза=спрятать глазаа
спускаясь на берег=спускаясь на беърег
спустив ноги=спустив ноъги
срикошетировали в стороны=срикошетировали в стоороны
срывать провода =срывать проводаааа 
стали владениями реки=стали владениями рекии
сталкикаясь=сталкиваясь
стало все равно=стало всё равно
стало немного все равно=стало немного всё равно
станет все отрицать=станет всё отрицать
становилось все больше=становилось всё больше
становился все сложнее =становился всё сложнее 
становился все темнее=становился всё темнее
становится все больше=становится всё больше
старушкам-контролершам=старушкам-контролёршам
Статью для Стила=Статьюу для Стила
Статью подготовит=Статьюу подготовит
стены беззвучно выросли=стеъны беззвучно выросли
Стены выбелены=Стеъны выыыбелены
стены дома=стеъны дома
стены её комнаты=стеъны её комнаты
стены и окна=стеъны и оъкна
Стены и потолок=Стеъны и потолок
стены карточных домиков=стеъны карточных домиков
Стены комнаты=Стеъны комнаты
стены комнаты=Стеъны комнаты
стены Кремля=стеъны Кремляа
стены на этот раз были=стеъны на этот раз были
Стены пещеры=Стеъны пещеры
степлером=стээплером
стерееобраз=стереообраз
стереодиалогом=стереодиалооогом
стереокамер=стереокаамер
стереоклип=стереоклиип
стереоотпечаток=стереоотпечааааток
стереоплощадка=стереоплощаааадка
стереоролик=стереорооолик
стереотекста=стереотеээкста
стереофоны=стереофоооны
стереошлем=стереошлеэээм
Стивенсона=Стииивенсона
стимулятор=стимуляатор
стинграми=стиинграми
Стингровая=Стииингровая
стингровая=Стииингровая
стингровой=стиингровой
стиплером=стээплером
стихов не помните=стихов не поомните
стоит в нескольких сантиметрах=стоиит в нескольких сантиметрах
стоит в стороне=стоиит в стороне
стоит на холме=стоиит на холме
стоит с плазмеметом в руке=стоиит с плазмомётом в руке
стоит с полуоткрытой дверцей=стоиит с полуоткрытой дверцей
стоит старый джентльмен=стоиит старый джентльмен
стоишь и внемлешь=стоиишь и внемлешь
стоишь как истукан=стоиишь как истукан
столоверчения=столоверчеээния
столодвижением=столодвижеэнием
столодержателей=столодержаателей
столодержатели=столодержаатели
стою над телом=стоюу над телом
стоят до конца=стояат до конца
стоят на летательных=стояат на летательных
стоят насмерть=стояат насмерть
стоят несколько девушек из технического=стояат несколько девушек из технического
стоящего в ангаре=стояащего в ангаре
стоящего над выгибающимся=стояащего над выгибающимся
стоящее напротив неё=стояащее напротив неё
стоящей рядом=стояащей рядом
стоящему рядом=стояащему рядом
стоящие вдоль них люди=стояащие вдоль них люди
стоящий в том же ряду=стояащий в том же ряду
стоящий на столе=стояащий на столе
стоящий около стены=стояащий около стены
стоящий точно в центре=стояащий точно в центре
стоящим в низинах=стояащим в низинах
стоящих в комнате=стояъщих в комнате
стоящую над ним=стояащую над ним
Странодержцы=Странодеэржцы
стрекота=стрёкота
стрелку перевел=стреълку перевел
стрельбовых=стреэльбовых
стридора=стриидора
стридоре=стриидоре
стридором=стриидором
стридору=стриидору
Строгино=Строогино
Строгинского=Строоогинского
строивших пристань=строивших приъстань
строила ему глазки=строила ему глаъзки
строительстве дорог=строительстве дороог
строить сначала дороги=строить сначала дороъги
струганными =струууганными 
струи горячего воздуха=струъи горячего воздуха
струи энергии=струъи энергии
ступневых=стуупневых
стучавшего в груди=стучавшего в грудии
Стэнфорда=Стээнфорда
Стэнфорде=Стээнфорде
Стюарт=Стюаарт
Суар=Суаар
суахили=суахиили
субпространство=субпростраанство
суггестологии=суггестолоогии
судьбы в тупике=суъдьбы в тупике
судьбы исчезнувших=суъдьбы исчезнувших
Судя по возбуждённому=Суъдя по возбуждённому
судя по всему=суъдя по всему
Судя по всему=суъдя по всему
Судя по выражению=Суъдя по выражению
судя по её движениям=суъдя по её движениям
Судя по его мучительным=Суъдя по его мучительным
Судя по звукам=Суъдя по звукам
судя по значкам=суъдя по значкам
Судя по их выразительным=Суъдя по их выразительным
судя по карте=суъдя по карте
судя по лицу=суъдя по лицу
Судя по насупившимся=Суъдя по насупившимся
судя по осторожному=суъдя по осторожному
судя по отвратительному=суъдя по отвратительному
судя по рассказу=суъдя по рассказу
Судя по решительному=Суъдя по решительному
Судя по сдаче=Суъдя по сдаче
судя по смердящему духу =суъдя по смердящему духу 
Судя по твоему=Суъдя по твоему
судя по твоему виду=суъдя по твоему виду
Судя по тени=Суъдя по тени
судя по тому=суъдя по тому
Судя по тому=суъдя по тому
судя по шагам=суъдя по шагам
судя потому=суъдя потому
Суккуб-1=Суккуб 1
Суккуб-2=Суккуб 2
Суккуб-3=Суккуб 3
Суккубу-1=Суккубу 1
сумасбродкой=сумасброодкой
сумеречности=суууумеречности
суммирование=суммииирование
суммы куда большие=суммы куда боольшие
суперадвокатура=суперадвокатууура
супергардеробчик=супергардерооообчик
супергигант=супергигаааант
супергроссмейстера=супергроссмеэйстера
суперделовой=суперделовооооой
супериндуктор=супериндуууктор
суперинститут=суперинституууут
Суперколлектор=Суперколлеээктор
Суперкомпьютер=Суперкомпьюуутер
суперлазер=суперлаазер
супермодной=супермоодной
супермозг=супермооозг
суперпамять=суперпаамять
суперпрестижный=суперпрестииижный
суперуравновешенная=суперуравновеээшенная
суперэлектроника=суперэлектроооника
суперэлектронной=суперэлектроооонной
суперэлитарный=суперэлитаааарный
сурки=суркии
сующий сей нос=суюущий сей нос
Счастливо вам всем=Счастлииво вам всем
счета и доносы=счетаа и доносы
считая дома=считая домаа
съёзда=съезда
сымпровизировал=сымпровизиировал
сымпровизировать=сымпровизиировать
сюрикены =сюрикээны 
тёплого плеча=тёплого плечаа
Тадденом=Таадденом
так все Шпагин да Шпагин=так всё Шпагин да Шпагин
так и игры=так и иъгры
Так и пело =Так и пеъло 
так остро=так оъстро
так уже вознагражден=так уже вознаграждён
такие условия игры=такие условия игрыы
Там глубины большие=Там глубиъны большие
тамаринда=тамариинда
тамариндов=тамарииндов
тамбурмажор=тамбур-мажор
тамбурмажорами=тамбур-мажорами
тамбурмажоров=тамбур-мажоров
тамбурмажоры=тамбур-мажоры
Танит-Змея=Танит-Змеяа
танцуешь =танцуъешь 
Танькину=Таанькину
таращит глаза=таращит глазаа
Тардье=Тардьеэ
тарельчатые=тареэльчатые
Тацит=Тациит
твердо стоит на китах=твердо стоиит на китах
твидовом=твиидовом
тела своих павших=телаа своих павших
телепатический=телепатиический
телепатической=телепатиической
темно-бордовая=тёмно-бордовая
темно-зеленом=тёмно-зеленом
темно-зеленый=тёмно-зеленый
темно-коричневом=тёмно-коричневом
темно-серого=тёмно-серого
темно-синей=тёмно-сиъней
темно-синий=тёмно-синий
темно-синим=тёмно-сиъним
темно-синяя=тёмно-синяя
темняках=темнякааах
тены тронного зала=стеъны тронного зала
теперь все просто великолепно=теперь всё просто великолепно
теперь на весу=теперь на весуу
тепла и волос=тепла и волоос
теплолюбивая=теплолюбиивая
теплолюбивую=теплолюбиивую
теплом происшедших перемен=теплоом происшедших перемен
Тереза=Тэрэза
Терезы=Тэрэзы
терминалку=терминаалку
тесно было в груди=тесно было в грудии
тетка соврала=тетка совралааа
теткин=тёткин
теткино=тёткино
теткиными=тёткиными
течет все медленнее=течет всё медленнее
ТИ-99=ТИ 99
Тираннозавр=Тираннозаааавр
Тираннозавры=Тираннозааавры
титулования =титулоования 
Тихонова=Тииихонова
то же самое=то же саамое
то что он обливался потом=то что он обливался поътом
Тогда все впереди=Тогда всё впереди
тоже самое=тоже саамое
той же самой многострадальной рубашки=той же саъмой многострадальной рубашки
той самой темнокожей девушки =той саъмой темнокожей девушки 
Токарева=Тооокарева
Токинса =Тоокинса 
толстые свечи=толстые свеъчи
толстыми кабелями=толстыми кабеляами
тоненькие струи воды=тоненькие струъи водыы
тоном судьи=тоном судьии
тонущую=тооонущую
топтуна=топтунааа
топтуны =топтуныыы 
тореро=торэро
торопящаяся=торооопящаяся
торцевой=торцевооой
торчащими в стороны=торчащими в стоороны
Точно я узнаю=Точно я узнаъю
Транксен=Транксээн
Транксена=Транксээна
Транксеном=Транксээном
тремором=треэмором
тренажер достоин самого=тренажёр достоин самовооо
тренажер имелся=тренажёр имелся
тренажером=тренажёром
тренажеры=тренажёры
треска очередей=треъска очередей
третьеразрядный=третьеразряаадный
трехходовок=трехходоовок
трешник=трёшник
три часа=три часаа
триммеров=трииммеров
Тринадцатитомник=Тринадцатитоооомник
Тристан=Тристаан
трубкообразными=трубкообраазными
трудноразличимые=трудноразличииимые
трудноразличимые слова=трудноразличииимые словаа
трудовикам=трудовикаааам
трудовики =трудовикииии 
трудовиков=трудовикоооов
трусливым потом губам=трусливым поътом губам
тс-тс-тс=тыссссс
туговато=туговаато
тульчан=тульчаан
тумблерами=тууумблерами
туповат=туповааат
Туполевых =Туууполевых 
тут все о'кей=тут всё о'кей
тут же подсели=тут же подсеъли
тушеночка=тушёночка
тщательно подбирала слова=тщательно подбирала словаа
Ты более смел=Ты более смеъл
ты забыла=ты забыыла
ты уже забыла=ты уже забыъла
тысячебальной=тысячебааальной
тьма-тьмущая=тьма-тьмуущая
т„мной=тёмной
у вас и методы=у вас и меэтоды
У дверей стоит охрана=У дверей стоиит охрана
у его парней=у его парнеэй
у которых жены=у которых жёны
у меня в груди=у меня в грудии
у меня дела=у меня делаа
у меня на душе=у меня на душеэ
у него все холодеет=у него всё холодеет
у него глаза=у него глазаа
у него на груди=у него на грудии
у него самого=у него самовооо
у него самого имелись=у него самовооо имелись
у нее ноги=у нее ноъги
у откоса дороги=у откоса дороъги
у постели больного=у постели больноого
у самого Владимира=у самовооо Владимира
у самого есть деньжата=у самовооо есть деньжата
у самого такая стоит=у самовооо такая стоиит
у тебя в долгу=у тебя в долгуу
у тебя самого=у тебя самовооо
У Эвелины разбежались глаза=У Эвелиины разбежались глазаа
убил Ринита=убил Рината
убитых и повернуть ход войны=убитых и повернуть ход войныы
убрала автомат=убралааа автомат
убрала с себя её ногу=убралааа с себя её ногу
увенчаны изящными тонкими рожками=увенчаны изящными тонкими рооожками
увидел все сразу=увидел всё сразу
увидел слезы=увидел слёзы
увидел стену напротив=увидел стенуу напротив
увидела стоящую передо мной=увидела стояащую передо мной
увидеть все это воочию=увидеть всё это воочию
увидятся хоть краешком глаза=увидятся хоть краешком глаъза
Увлёченная=Увлечённая
увозить Минни далеко=увозить Минни далекооо
угольно-красную=уугольно-красную
угольно-красным=уугольно-красным
удалось получить сведения=удалось получить свеээдения
Удары сердца грохотали=Удары сеърдца грохотали
удачливые сучки=удачливые суъчки
удерживая на весу=удерживая на весуу
удивлению самого Владимира=удивлению самовооо Владимира
уже стоит лошадиный=уже стоиит лошадиный
узкий в груди=узкий в грудии
узнает для чего=узнаъет для чего
Узнает ли он =Узнаъет ли он 
узнает об этом человечество=узнаъет об этом человечество
узнаешь на месте=узнаъешь на месте
Узнаешь позже=Узнаъешь позже
узнают в задержанных патентованных уголовников=узнаъют в задержанных патентованных уголовников
укатанному снегу дороги=укатанному снегу дороъги
укрылся за кустами и замер=укрылся за кустами и заъмер
улет=улёт
улетела на обустройство временного лагеря =улетела на обустроойство временного лаагеря 
Улица круто сбегает=Улица круто сбегаает
Ум-м-м=Уммм
Ум-м-мххх=Умммххх
умиротворяюще=умиротворяаающе
умолк и замер=умолк и заъмер
умостился=умостиился
умотала=умотаала
унял слезы=унял слёзы
упакованных тюка=упакованных тюкаа
уперев в бока руки =упереээв в бока руъки 
упершейся в тупик жизни=упершейся в тупиик жизни
Упсалы=Упсалыыы
Уралом=Ураълом
успели оценивающе обежать=успели оцеээнивающе обежать
устранимым=устраниимым
устршающий=устрашающий
утер слезу =утер слезуу
утилизатор=утилизаатор
утилизаторе=утилизааторе
утилизатором=утилизаатором
утилизатору=утилизаатору
утилизаторы=утилизааторы
утопали в сыром =утопаали в сыром 
Утрите слезы =Утрите слёзы 
Уф-ф-ф=Уффф
уха Зубцова=уъха Зубцова
ухало в груди=ухало в грудии
ухарски=уухарски
ухнулась=уухнулась
ухоженностью=ухооооженностью
участку дороги=участку дороъги
участок дороги=участок дороъги
ученые поднялись на плато острова=ученые поднялись на плато оострова
ученый все просмотрит=ученый всё просмотрит
учимся =уучимся 
учтут все это в предстоящей=учтут всё это в предстоящей
ушла от их зубов=ушла от их зубоов
ушло из самого воздуха=ушло из самовооо воздуха
ушу=ушуу
Уэллс=Уээллс
фаерболов=фаербоолов
Фамилия матери=Фамилия маатери
Фамусова=Фааамусова
фантасмагоричнее=фантасмагорииичнее
фараонша=фараоонша
Федерал=Федерааал
феномен теоретически допустим=феномен теоретически допустииим
фермер-сотенник=фермер-соотенник
Фернан=Фернаан
фигец =фигеэц 
фигню=фигнюу
фиговость ситуации=фииговость ситуации
физико-химических=фиизико-химических
фильмотеки=фильмотеэки
фильмотеку =фильмотеэку 
фильтровальщик=фильтроваальщик
фиолетовый камушек на поле=фиолетовый камушек на поъле
фирмочку=фиирмочку
флибустьерской=флибустьеэрской
Фляшон=Фляшоон
Фомой=Фомоой
фоновый запах =фоновый заъпах 
фонтанчиками=фонтаанчиками
фонтанчики пыли=фонтанчики пыъли
Формасьон=Формасьооон
фотоавтомата=фотоавтомаааата
Фревиллом=Фреэвиллом
френчиках=фреэнчиках
Фффу-у-у-хххх=Фффу-у-у-х
Фьери=Фьерии
фэнтези=фээнтэзи
Хаваем =Хааваем 
хаваете=хаааваете
хакера=хаакера
Хамовнического=Хамооовнического
хамово=хаамово
характере самого матча=характере самовооо матча
характерной для него=характеэрной для него
характерном обличье=характеэрном обличье
характерные больничные звуки=характеэрные больничные звуки
характерные методы =характеэрные меэтоды 
характерные урчание=характеэрные урчание
характерный хлопок=характеэрный хлопок
хвостиками волос=хвостиками волоос
хеппи-энд=хэппи-энд
хипарь=хипаарь
Хирохито=Хирохиито
хитренькая=хииитренькая
хитровато=хитроваато
хлопается=хлооопается
хлорамина=хлорамиина
хлямом=хламом
Хм-м-м=Хыммм
хозяева и слуги=хозяева и слуъги
ХОКС=хокс
хоксировали=хоксиировали
хоксировании=хоксииировании
хоксированная=хоксииированная
хоксированного=хоксииированного
хоксированную=хоксииированную
хоксированные=хоксииированные
Хоксированный=Хоксиированный
хоксированных=хоксиированных
Хоксируемым=Хоксиируемым
хоксируемыми=хоксииируемыми
холеное лицо=холёное лицо
холеный лорд=холёный лорд
холодным потом=холодным поътом
Хотите виски=Хотите виъски
Хочешь все видеть=Хочешь всё видеть
Хрестуса=Хреэстуса
Хрестусы=Хреэстусы
хрустальные замки просели=хрустальные заъмки просели
Хуан=Хуаан
худо-бедно=худо-беъдно
Царицей-телепаткой =Царицей-телепааткой 
Цвейга=Цвейгга
цвета вороненой стали=цвеъта вороненой стали
цвета воронова крыла=цвета вороноова крылаа
цвета и запаха=цвета и заапаха
цветных витражей окна=цветных витражей окнаа
Целую - твоя мама=Целуъю - твоя мама
целую семью=цеэлую семьюу
Центр-1=Центр 1
Центру-1=Центру 1
Цестия=Цеэстия
Циолковский=Циолкоовский
цокот копыт в ночи=цокот копыт в ночии
цэка=цэкаа
чё-ё-о-о-о-рт=чё-ё-о-о-орт
чаек нет=чаъек нет
чаек уже отпили=чаек уже отпиъли
Чапаевича=Чапааевича
Чапаевичем=Чапааевичем
Чапаевичу=Чапааевичу
Чапай=Чапаай
ЧАРЛЬЗ=Чарльз
чародейка=чародеэйка
Чаррелом=Чааррелом
Часа в три=Часаа в три
Часа два=Часаа два
часа два назад=Часаа два назад
часа полтора=часаа полтора
части несложного уравнения - крупа=части несложного уравнения - крупаа
частиком=чаастиком
чвиркала=чвииркала
чего смотрите=чего смоотрите
чего стоишь=чего стоиишь
чего-нибудь=чего-нибуудь
чей-нибудь=чей-нибуудь
человек лет сорока=человек лет сорокааа
человекам=человеэкам
человеконенавистнической=человеконенавиииистнической
человекоубийства=человекоубииийства
чем у утопающего=чем у утопаающего
чем-нибудь=чем-нибуудь
червеобразность=червеобрааазность
через 10 минут=через 10 минуут
через часа два=через часаа два
через четыре дома=через четыре доъма
черемушек=черёмушек
черепашек-ниндзя=черепаашек-ниндзя
чересчур далеко=чересчур далекооо
черканьем=чёрканьем
черно-белые=чёрно-белые
черно-белый=чёрно-белый
Черно-желтое=Чёрно-желтое
черно-желтых=чёрно-желтых
черно-рыжими=чёрно-рыжими
Черноземья=Чернозеэмья
черной бусинкой глаза=черной бусинкой глазаа
черный ноутбук =черный ноутбууук 
честно признаюсь=честно признаъюсь
четверть часа пересъемка=четверть часа пересъёмка
четырёхлучовыми=четырёх-лучевыми
четырёхрукий=четырёхруукий
четырёхрукого=четырёхруукого
четырёхсотмиллиметровые=четырёхсот-миллиметроовые
четырехкрылая=четырех-крыылая
Четырехпроцессорный=Четырех-процессорный
четырехчасовую видеокассету=четырех-часовую видеокассету
читал статью=читал статьюу
читающего чьи-то звенящие строки=читающего чьи-то звенящие строъки
чревато далеко не радужными=чревато далекооо не радужными
что было силы начал грести =что было силы наъчал грести 
что губы=что гуъбы
что поступите разумно=что постуупите разумно
что-нибудь=что-нибуудь
чувствовал себя все хуже=чувствовал себя всё хуже
чудиться оттенки благодарности=чуудиться оттенки благодарности
чудненько=чуудненько
чуждостью=чууждостью
чурбачок=чурбачооок
чуточкой=чууточкой
чухан=чухаан
чухнулись=чуухнулись
чье-нибудь =чье-нибуудь 
чьих-нибудь=чьих-нибуудь
чья-нибудь=чья-нибуудь
Ш-ш-ш=Шшшы
Шалтай-Болтай=Шалтаай-Болтай
шамберьер=шамберьеээр
Шамиль=Шамииль
шандарахнув=шандараахнув
шанс все исправить=шанс всё исправить
шансонье=шансоньеээ
шарлатански=шарлатаански
шаром покати что в холодильнике=шароом покати что в холодильнике
шепоточком=шепотоочком
Шерлоке=Шеэрлоке
шестидесятикилограммовые=шестидесяти-килограммовые
шестидесятипятилетним=шестидесяти-пяти-летним
шестидесятисемилетний=шестидесяти-семилетний
шестиместном=шестимеэстном
шестимильной=шестимиильной
шестиструнка=шестиструунка
шестый=шестой
ширнуться=шиирнуться
Широка страна=Широкааа страна
широколобым=широколоообым
шиферными=шиииферными
шишкомотальная=шишкомотаальная
шлем-маской=шлеъм-маской
Шлимана=Шлиимана
шмякнулась=шмяакнулась
Шобера=Шообера
Шпагина=Шпаагина
Шпагина-биолога=Шпаагина-биолога
Шпагине=Шпаагине
Шпагину=Шпаагину
Шпагиным =Шпаагиным 
шпенечек=шпенёчек
шпенечком=шпенёчком
шпийон =шпийоон 
шприцевым=шприцевыыым
Шторм-2=Шторм 2
Шторм-3=Шторм 3
Шторма-2=Шторма 2
Шторма-3 =Шторма 3 
Шторме-3=Шторме 3
Штормом-2=Штормом 2
Шторму-2=Шторму 2
штурмовиком на плече=штурмовиком на плечеэ
шуранули=шурануули
шуры-муры=шуры-муъры
щеки и губы=щёки и гуъбы
щеки на морозе=щёки на морозе
щемление в груди=щемление в грудии
щуря глаза=щуря глазаа
Эвелина=Эвелиина
Эвелине=Эвелиине
Эвелиной=Эвелииной
Эвелину=Эвелиину
Эвелины=Эвелиины
Эврика=Ээврика
Эдисонов=Эдисоонов
экзекуционная=экзэкуциооонная
экзекуционную =экзэкуциооонную 
электрогазовой=электрогааазовой
электрозащиты=электрозащииты
электронно-вычислительная=электроонно-вычислительная
электронно-вычислительные=электроонно-вычислительные
электрообогреватель=электрообогревааааатель
электроодеяло=электроодеяаало
электрооткрывателя=электрооткрывааателя
электрочайник =электрочааайник 
Элиоле=Элиооле
Эмбрионально=Эмбрионааально
Эмилиано=Эмилиааано
энергоблагодетеле=энергоблагодеэээтеле
энергоинформарий=энергоинформааааарий
Энергочудовище=Энергочудооовище
энергочудовище=Энергочудооовище
эпатировать самого=эпатировать самовооо
эпилептоидным=эпилептооидным
эрстедов=эрстэдов
эрэсэфэсэр=эрэсэфэсээээр
Эт-т-та-а-а=Эттта-а-а
эт-т-то =эттто 
это ее слова=это ее словаа
это не только слова=это не только словаа
это очень пошло=это очень поъшло
Это пугало Владимира=Это пугаъло Владимира
Это равно безумная затея=Это раъвно безумная затея
Это так здорово=Это так здоорово
Это уже типично английская черта=Это уже типично английская чертаа
этой самой слезинки=этой саъмой слезинки
Ю-179=Ю 179
Юнион=Юниооон
Юрием=Юурием
Юрию=Юурию
Юрия=Юурия
я была горда=я была гордаа
Я вижу берег=Я вижу беърег
Я все видел=Я всё видел
я все жду=я всё жду
Я все знаю=Я всё знаю
Я все о старом=Я всё о старом
я все понял=я всё понял
Я даже стала высыпаться=Я даже стала высыпааться
я запомнил слова=я запомнил словаа
я и засыпал каждую ночь=я и засыпааал каждую ночь
Я повторяю слова=Я повторяю словаа
язык какой-то чудной=язык какой-то чудноой
язычница может быть спасена=язычница может быть спасенааа
Яйлы=Яйлыы
Яночка=Яаночка
ясеневую=яааасеневую
яхточке=яахточке
яхточку=яахточку
Яшина=Яашина
ящерки=яащерки
